source,num_exts,num_uniq_exts,percent_uniq_exts,total_exts,total_uniq_exts,added_uniq_exts,uniq_exts
wikidata,7637,2299,30.103443760638996,7637,7637,7637,"['lrr', 'motif', 'blc', 'rsct', 'resmoncfg', 'appcache', 'ptls', 'mlappinstall', '3dn', 'wl1', 'slrnrc', 'dfa', 'mcworld', 'amplxeproj', 'lproj', 'hmc', 'wlnet', 'g723', 'txvclassdiagram20', 'f64', 'ac4sp', 'zan', 'e4xmi', 'efa', 'vs1', 'poly', 'grc', 'ef', 'pcam', 'sck', 'fex', 'mwm', 'fmi', 'rw1', 'notecard', 'etherpad', 'bec', 'wk', 'inv', 'arpbank', 'dbox', 'u00', 'm3f', 'dsg', 'sog', 'arduboy', 'graph', 'v3d', 'wap', 'dylan-console', 'v3m', 'scheme', 'module', 'xcconfig', 'elas', 'folders', 's37', 'mkt', 'lwc', '3dp', 'm10', 'mn5', 'lps', 'material', 'gmsynth', 'nhf', 'pio', 'vpo', 'tivo', 'nnb', 'uqm', 'ev3b', 'desksoftlicense', 'bco', 'tq2', 'edml', 'or5', 'phpimci', 'asb', 'cvcert', 'cjr', 'pro6', 'pvc', 'iinv', 'fzv', 'sox', 'gof', 'lmt', 'hse', '4df', 'palm', 'elev', 'pimg', 'oht', 'pvt', 'nrd', 'aibb', 'ha12', 'masm', 'omn', 'ede', 's4mi', 'mrv', 'mphtxt', 'ti', 'monopic', '_01', 'ha2', 'tbd', 'frc', 'ofl', 'dre', 'bbp', 'batch', 'ppz2', 'usx', 'hhe', 'sbj', 'lut', 'adw', 'provbank', 'bvy', 'mz5', 'smgsce', 'iap', 'an1', 'odttf', 'jp6', 'instr', 'mzmlb', 'ncm', 'vwp', 'sfi', 'mn9', 'cs1', 'stproj', 'maql', 'mplog', 'mux', 'acro', 'ytt', 'psyexp', 'ev3e', 'mn3', 'fbd', 'syo', 'bbc', 'ldl', 'syf', 'cqe', 'ubz', 'hexset', 'rw3', 'hnt', 'ac4', 'lav', 'tmv', 'smgxml', 'oprops', 'singularity', 'sak', 'vqa', 'mclib', 'nx5', 'xorg.conf', 'bsx', 'flz', 'g1a', 'npc', 'stv', 'rcm', 'fmg', 'fef', 'myf', 'fcpx', 'ocs', 'ktp', 'clz', 'hod', 'ymv', 'fprg', '3sd', 'atp3', 'daw', 'sgr', 'lcry', 'ppl', 'qot', 'ejpg', 'adfs', 'genh', 'h6v', 'qct', 'skel', 'rpk', 'torsion', 'spw', 'spbm', 'd.ts', 'cok', 'pie', 'dtq', 'z64', 'dub', 'ldjson', 'file', 'wncry', 'cnsf', 'mii', 'ngs', 'fabbproject', 'mythsav', 'slf', 'spt', 'pubkr', 'wskn', 'lsa', 'kvk', 'iwl', 'wet', 'qr2', 'rwd', 'pxe', 'zdb', 'kegs', 'g722-6', 'qtvr', 'dx7', 'pa1', '3wd', 'dtt', 'teal', 'txp', 'tek', 'bsearch', 'joc', 'fg4', 'idsp', 'dewf', 'axg', '4mu', 'ci6', 'pcsav', 'reqifz', 'jci', 'mexa64', 'aer', 'txvactivitydiagram20', 'gy', 'bfwav', 'tbmat', 'dv-avi', 'pagx', 'ztt', 'x3a', 'scy', 'adobebridge', 'rwo', 'mvt', 'lhw', 'import', 'ric', 'sbl', 'psg', 'fconfig', 'mldf', 'bj', 'hdc', 'gthr', 'mof', 'mmv', 'thumbs.db:encryptable', 'vex', 'apks', 'jic', 'spayd', 'sdml', 't27', 'songsmith', 'jlqm', 'w7w', 'htaccess', 'rx', 'jpg2', 'instances', 'cib', 'gob', 'cvz', 'jsgf', 'duckdb', 'dzprj', 'epdf', 'ldp', 'safetensors', 'kmap', 'yra', 'ecd', 'lb6', 'mprops', 'stj', 'hpt', 'mti', 'f4p', 'msstyles', 'gchord', 'd4m', 'rpmsg', 'tasm', 'smdevice', 'ms3', 'wprops', 'asr', 'mrlv', 'lasx', 'clc', 'video.mcf', 'era', 'rua', 'sad', 'umlclass_diagram', 'accdr', 'bmfc', 'mrx', 'alg', 'symmod', 'a8t', 'd2m', 'vbo', 'epv', 'pubxml', 'ispro', 'xdv', 'iti', 'bll', 'gtkw', 'eqconfig', 'vpc', 'nsz', 'vwl', 'l86', 'sobj', 'qxcf', 'jspf', 'lnarc', 'grle', 'gef', 'ueb', 'px4', 'rco', 'hld', 'zco', 'ahu', 'dec', 'vvi2', 'jwp', 'alv', 'mdn', 'dxfp', 'ei', 'byu', 'cor', 'zvi', 'ckit', 'dsu', 'ioc', 'pop.ncdf', 'mmcif', '6pack', 'ppmz2', 'pjx1', 'atl', 'ghx', '32', 'ba2', 'lvl', 'g726-2', 'scrpt', 'qdt', 'oom', 'drawing', 's1a', 'zook', 'svt', 'beancount', 'cee', 'md5mesh', 'pkt', 'schrepx', 'al2', 'jwpub', 'mn7', 'hfd', 'xbv', 'opam', 'binpb', 'dmkit', 'fchk', 'eywx', 'ptu', 'qbe', 'meta4', 'fstf', 'rockwell-3', 'gmod', 'cnm', 'ttb', 'omg', 'tv3', 'uht', 'lrt', 'adlib', 'ssdl', 'kk3', 'ns2p', 'tzf', 'skba', 'pbtx', 'lzham', 'ade', 'pont', 'wan', 'abb', 'pzw', 'd07', 'gbf', 'pfcolors', 'apg', 'indk', 'ggxml', 'tbh', 'epsg', 'vpf', 'ebf', 'vuze', 'g3w', 'zipe', 'lsmv', 'gc', 'nbk', 'tiencr', 'rln', 'hwa', 'arl', 'luacodec', 'oleo', 'kbe', 'nqc', 'ccz', 'igtx', 'age', 'mae', 'camp', 'glo', 'abicollab', 'cdi', 'mips', 'w7a', 'kim', 'g726', 'gdtb', 'frinika', 'journal', 'bf2', 'pdu', 'mwk', 'wproj', 'shfbproj', 'corgr', 'drr', 'w2ent', 'familyx', 'sbp', 'mpr', 'st6', 'afw', 'qvs', 'skchr', 'hbw', 'brw', 'twr', 'vgr', '6pk', 'c3p', 'comx', 'tnt', '3gpp2', 'rem', 'gabc', 'apj', 'cc1', 'w8v', 'nrh', 'xjt', 'mwz', 'irt', 'remotemap', 'isd', 'ggpk', 'emx', 'sca', 'roh', 'aweblib', 'slaz', 'ymt', 'pvi', 'mapx', 'cvl', 'fasm', 'perlapp', 'lgr', 'in2d', 'vef', 'ths', '2d', 'mgs', 'ds3', 'bx', 'jzlib', 'uidl', 'oap', 'pr', 'r2r', 'hw6', 'ta8', 'rvdata2', 'ocio', 'lia', 'cjm', 'gff', 'omr', 'edk', 'rgf', 'sep', 'h5rage', 'nop', 'itmx', 'isa', 'cac', 'fix', 'viz', 'muib', 'hdprg', 'plxml', 'ta7', 'exrc', 'dfd', 'watchface', 'hma', 'dsres', 'sur', 'qxf', 'btc', 'sue', 'adsklib', 'qcow3', 'sab', 'jdp', 'sob', 'avl', 'x0v', 'rb2', 'xjb', 'tfe', 'ewnet', '3dsx', 'mbtiles', 'ps2', '3dw', 'gff3', 'svp', 'gbxml', 'mvpl', 'bashrc', 'tn5', 'psntemplate', 'snobol', 'fogui', 'rlv', 'fhs', 'kam', '4dff', 'sxz', 'rtbw', 'cedf', 'jcf', 'gise', 'xgl', 'vfproj', 'caq', 'ispac', 'bifxml', 'kpj', 'ppu', 'c3t', 'aem', 'puf', 'image/nie', 'ewp', 'ezf', 'mji', 'fbp', 'loadtest', 't77', 'exec', 'rpa', 'zx', 'pnps', 'efs', 'ubj', 'cqm', 'lyz', 'tscproj', 'fdxt', 'c--', 'sets', 'tsd', 'pysu', 'sf2pack', 'mwproj', 'nklm', 'mwdeck', 'lvlps', 'gipl', 'qmc', 'dpal', 'spz', 'lxt', 'ezpx', 'unf', '3dv', 'hle', 'mdu', 'rsf', 'ffs_gui', 'borders', 'at', 'svar', 'fbp4', 'rsdk', 'share', 'aii', 'dmpatch', 'gle', 'exo', 'g722-8', 'kvt', 'gwb', 'ogex', 'bmsk', 'wtf', 'mus10', 'fbr', 'ybn', 'crv3d', 'users', 'icspkg', 'rlb', 'pzs', 'gguf', 'ltp', 'ahs', 'acre', 'dda', 'wire', 'ifbf', 'grfx', 'smgview', 'dtproj', 'ydd', 'msixbundle', 'hcxs', 'gaz', 'rwt', 'mbz', 'wfp', 'pbh', 'hsd', 'ebs', 'sitemap', 'cx', 'sgp', 'pyz', 'sul', 'fpc', 'brep', 'jzml', 'sn4', 'dfdl.xsd', 'ruleset', 'rdbdata', 'hewsp', 'tv1', 'ids2', 'hexdwc', 'freshroute', 'qba', 'owx', 'mphbin', 'nexus', 'srec', 'mqf', 'hcs', 'dyn', 'hip7', 'enmap', 'spi3d', 'ad_asm', 'qxmt', 'wtt', 'zu', 'cmxa', 'scg', 'dotfuproj', 'pa2', 'hxw', 'tdms', 'mwsymb', 'csa', 'af3', 'bna', 'mcpack', 'incgr', 'qhcp', 'kct', 'tox', 'ckb', 'gltth', 'nq', 'blsc', 'jui', '1tl', 'apkm', 'wbdp', 'ccw', 'lpkg', 'rpd', 'sment', 'ts3_addon', 'zda', 'osn', 'w2a', 'mapcss', 'wme', 'ofn', 'cmyk', 's3o', 'sgz', 'mvdx', '3sl', 'trig', 'elpi', 'dmptrn', 'yop', 'tke', 'reqif', 'cast', 'scntoc', 'pvl', 'mjl', 'tpc', 'dri', 'pseg', 'oxp', 'gmbl', 'psl', 'ovs', 'tpy', 'textclipping', 'bis', 'hmd', 'o5c', 'mktx', 'sql.j2', 'rff', 'vproj', 'vin', 'sunvox', 'k3g', 'bbl', 'hipnc', 'jos', 'lc', 'brfnt', 'e4i', 'pnws', 'bdd', 'settings', 'eka', 'tmod', 'zlx', 'awebplugin', 'bp1', 'psmdcp', 'ymap', 'c01', 'nbs', 'tiger', 'nist', 'vet', 'dj', 'ifs', 'ndpi', 'tal', 'wgm', 'nx4', 'fmc', 'blif', 'tmc600', 'hotlist', 'tmb', 'wdiff', 'nbt', 'gw3', 'wlf', 'fdneut', 'tv6', 'vdjsample', 'hrm', 'bntx', 'hsz', 'jsxinc', 'hgm', 'sbd', 'fc3map', '3dl', 'tnfo', 't06', 'bfsar', 'me3headmorph', 'ridl', 'tup', 'lgd', 'mnx', 'fb3', 'mze', 'udn', 'pwr', 'typoscript', 'yace', 'dmr', 'xiz', 'jsrc', 'stng', 'typelib', 'i90', 'dcupdate', 'val', 'crmsh', 'fm2', 'bridgecache', '4dosav', 'mdsx', 'pbb', 'cow', 's24', 'libzip', 'f1q', 'sw2', 'mui', 'sqlite3-console', 'xpp', 'mlpkginstall', 'vsps', 'inrs', 'psq', 'kxf', 'fve', 'a4w', 'l3b', 'spi1d', 'dja', 'scb', 'kb', 'signal', 'lcf', 'vrscene', 'qbm', 'cprops', 'pb0', 'npw', 'pop', 'mjd', 'vjsproj', 'kva', 'sbmi', 'fmu', 'xmz', 'bfd', 'stencil', 'lbo', 'lmp', 'sla.gz', 'ldaprc', 'd08', 'ale', 'epc', 'tarc', 'sdz', 'kn', 'rwe', 'wtml', 'amp', 'prom', 'dgm', 'm4s', 'ezdrawlibb', 'pbiviz', 'acs4', 'uasset', 'bfont', 'gbm', 'kfa', 's1m', 'p86', 'aue', 'wfc', 'ontx', 'vault', 'hpr', 'farconfig', 'rlt', 'psess', 'odx', 'bash_profile', 'battle', 'drawlog', 'tbx', 'cwa', 'ep1', 'zpr', 'lnd', 'tri', 'uvopt', 'nd', 'hyb', 'mn2', 'dbh', 'aria', 'z_t', 'dat1', 'ssw', 'enpack', 'avroskin', 'mn6', 'materials', 'ltn', 'txk', 'ezt', 'logbook3', 'geodatabase', 'or3', 'pau', 'mcm', 'dfpwm', 'swe', 'compiled', 'newick', 'pbj', 'unif', 'if', 'jem', 'vtm', 'glksave', 'squid.conf', '0fn', 'wizard', 'ehsx', 'vsb', 'tprops', 'mfa', 'motivi', 'ccb', 'ride', 'sup', 'exdg', 'ett', 'rde', 'cae', 'hti', 'ekc', 'pew', 'wmlf', 'shortcuts', 'camm', 'promql', 'csg', 'jma', 'fprops', 'aglib', 'ema', 'senc', 'cscheme', 'ap6', 'script', 'pbs', 'mse', 'state', 'ssx', 'gin', 'tbgn', 'evoque', 'soft', 'object', 'vtml', 'prl', 'kr1', 'rnqs', 'csy', 'abdata', 'wibucmrau', 'av.mcf', 'srp', 'gvimrc', 'vbf', 'uvd', 'anme', 'znc', 'ngb', 'coords', 'dsi', 'chart', 'hgd', 'kmn', 'mwd', 'y3d', 'pro5', 'bssc', 'bop', 'l3r', 'tssproj', 'nktrl2_data', 'pb1', 'spg', 'mi', 'uplugin', 'trace', 'rvc', 'mixindex', 'pmdriver', 'tun', 'lzu', 'cmarkers', 'yay0', 'rmr', 'rpak', 'demi2', 'rgss3a', 'ovd', 'pgmf', 'ufnt', 'vt2', 'dr8', 'cfw', 'amgp', 'f4b', 'itn', 'xtd', 'empo', 'feat', 'lisaem', 'sg4', 'jslt', 'd5p', 'd06', 'psci', 'accdc', 'x3v', 'aal', 'pnproj', 'dprops', 'rho', 'gxml', 'axp', 'rpz', 'spider', 'matte', 'pqo', 'qef', 'efk', 'i6t', 'wadl', 'jiff', 'vect', 'mh', 'rproj', 'tvn', 'kv6', 'copc', 'aexpk', 'lth', 'fph', 'mkr', 'ba8', 's1', 'emailcache', 'mobirise', 'dzi', 'abbu', 'omp', 'mel', 'arb', 'nom', 'syv', 'wof', 'mn8', 'keyboard', 'nginx.conf', 'itc2', 'yaz0', 'erwin', 'uvprojx', 't88', 'nsla', 'pixexp', 'osz', 'cgl', 'x0a', 'gdg', 'wfbe', 'dhw', 'dcls', 'qlr', 'rslib', 'etc', 'xav', 'uai', 'lpaq1', 'pmml', 'sngbase', 'ffxml', 's8theme', 'qdat', 'color1', 'pse', 'wpx', 'wwu', 'algobuild', 'jucer', 'dsx', 'tah', 'phyloxml', 'sbox', 'mb1', 'kdevprj', 'tr2', 'railmlx', 'zls', 'ytyp', 'smb', 'utk', 'dxn', 'tl4', 'sh~', 'ion', 'avchd', 'mpex', 'ig4', 'tg', 'fxe', 'tkp', 'animl', 'mcschema', 'mfv', 'jed', 'fc0', 'gchone', 'qdfm', 'cdv', 'etv', 'starpak', 'cyprj', 'si4', '3da', 'ad_prt', 'lot', 'jml', 'lgl', 'sppack', 'rockwell', 'hck', 'sbsasm', 'tsi', 'bigbed', 'sdlproj', 'arexx', 'stapl', 'qop', 'meg', 'st13', 'zf3d', 'gel', 'xvy', 'hiof', 'pup', 'st0', 'aln', 'esps', 'wph', 'cc2', 'bare', 'ava', 'sqlplan', 'pc', 'nfd', 'coasts', 'kcw', 'efq', 'streamdb', 'ðŸ”¥', 't@0', 'umx', 'xsf', 'generictest', 'svcinfo', 'ssmsmobileproj', 'smiles', 'ydr', 'shl', 'bfi', 'mjt', 'v2d', 'ghlayout', 'gw2', 'ai4', 'ayl', 'bbz', 'mfs', 'wmal', 'mtc', 'rmtl', 'kp', 'srcinfo', 'gor', 'tax2009', 'xml.bz2', 'iw5dlc', 'awses', '404', 'itw', 'pkf', 'stencyl', 'eth', 'mrxs', 'lzt', 'rac', 'glfont', 'pd~', 'meson.build', 'mc3', 'xsz', 'prod', 'nrb', 't0ast', 'pwdump', 's7i', 'bra', 'g722-7', 'rwm', 'rvd', 'attachment', 'wxm', 'nja', 'twx', 'mrg', 'rfg', 'gcl', 'jet', 'fow', 'roz', 'eui', 'rbxmx', 'rrr', 'h4r', 'rawvox', 'zcode', 'csdl', 'lwh', 'jba', 't8c', 'lsg', '005', 'mwv', 'b4a', 'jsa', 'ytd', 'phst', 'bkd', 'phone', 's19', 'mn4', 'mpkx', 'f1d', 'gossett', 'civ5sln', 'scen', 'zx1', 'xpz', 'gtr', 'omdoc', 'jex', 'isym', 'sel', 'fdm_material', 'ppkx', 'the', 'ts1', 'kdevses', '64c', 'qvto', 'html-wp', 'mt5', 'msix', 'ifx', 'omt', 'rivers', 'ao', 'nk', 'vab', '3dmbak', 'ufp', 'vfn', 'ls3proj', 'si3', 'rdo', 'cwy', 'ai7', 'rs5', 'uml', 'brl', 'g726-5', 'qmv', 'alpha', 't09', 'spm', 'xly', '2bit', 'vscn', 'gdiff', 'gitmodule', 'ktf', 'qtk', 'uvp', 'database', 'pbl', 'ndk', 'mixstatus', 'pprj', 'cwf', 'xd', 'music', 'bxrc', 'm11', 'civ5proj', 'bphys', 'sndr', '3dmlw', 'v4p', 'wcst', 'tss', 'u8', 'cde', 't08', 'ab5', 'r2lang', 'sgv', 'tl1', 'ovpn', 'brseq', 'af2', 'country', 'smufi', 'sql.jinja2', 'snt', '2hd', 'wpp', 'stmx', 'rxt', 'ipsw', 'iqt', '4d', 'contest', 'ulz', 'simmeshdb', 'bpi', 'a4l', 't2', 'cho', 'tin', 'mmb', 'wfd', 'spl7', 'uvn', 'sltx', 'lsn', 'hhb', 'tax2008', '2dm', 'xdf', 'enf_abq', 'cyg', 'lv', 'opl', 'ltm', 'mogrt', 'b2s', 'rbxlx', 'hsh', 'aat', 'mspxml', 'cgc', 'lgf', 'arrow', 'rpyc', 'yft', 'eu4', 'os6', 'rita', 'synw-snippet', 'sil', 'alf', 'sn3', 'vdproj', 'emdl', 'jse', 'l3k', 'mqsc', 'dg', 'kx', 'gw', 'ed6', 'pcif', 'w2w', 'color', 'exx', 'mfi', 'town', 'jtf', 'zw', 'kcmsf', 'osim', 'dmo', 't29', 'usb', 'ctc', 'lbrn', 'bigwig', 'bez', 'vbox-prev', 'gxt', 'cromfs', 'psym', 'rcf', 'xtm', 'n3d', 'tn6', 'dlr', 't07', 'paln', 'bfft', 'f3r', 'rgss2a', 'map2video', 'kdelnk', 'gplt', 'amm', 'vek', 'pmtiles', 'uproject', 'pdw', 'demset', 'g2w', 'notion', 'pmbc', 'upj', 'shd', 'foguischeme', 'pjm', 'wke', 'tvm', 'cbmprj', 'nex', 'islands', 'xdmf', 'exi', 'bb6', 'lwr', 'or4', 'hns', 'taml', 'hnm', 'a8k', 'vmu', 'aren', 'vj', 'asec', 'treetop', 'datgr', 'sparseimage', 'bbmodel', 'sp3', 'accdt', 'bnf', '264', 'ste', 'pecom', 'ivml', 'tibkp', 'ed5', 'vismatzip', 'wfl', 'uvoptx', 'aprx', 'mce', 'pro4', 'seexpl', 'strokes', 'mkb', 'n64', 'lqm', 'xtl', 'acelive', 'kxr', 'fract', 'vdu', 'nbattrs', 'architect', 'pfdc', 'rgd', 'brainzip', 'wacomxs', 'x3w', 'chq', 'ltw', 'dulk', 'synw-proj', 'mha', 'tq5', '3bd', 'bky', 'ccvf', 'tmt', 'hrc', 'mxr', 'nbz', 'emu', 'zpj', 'semblio', 'winmd', 'ugf', 'hsn', 'juttle', 'cry', '1pif', 'ufr', 'psn', 'eda', 'htpasswd', 'uis', 'weba', 'klc', 'hxi', 'preset', 'svn', 'pkinfo', 'zlic', 'ftlx', 'idx2', 'pn', 'fgeo', 'vdata', 'dgu', 'aft', 'oph', 'vge', 'wxg', 'v64', 'gdc', 'epx', 'xsym', 'smdlproj', 'w7v', 'ori', 'pop.nc', 'ligt', 'mlx', 'ms2', 'gli', 'sfarr', 'ubb', 'spmod', 'ays', 'amod', 'g723-3', 'c2pa', 'btsearch', 'wusikpack', 'anm2', 'g6', 'hls', 'mmx', 'cg3', 'wwd', 'ml2', 'nhd', 'gpml', 'dzip', 'tch', 'wsi', 'rtp', 'edmx', 'hsail', 'publishproj', 'xjtgz', 'itx', 'alaw', 'lgc', 'eed', 'ely', 'altstate', 'eg', 'edt', 'edv', 'ncm2', 'fmo', 'coff', 'sunsynth', 'groupproj', 'laa', 'd3plot', 'yrr', 'dtsconfig', 'qxi', 'vvp', 'ai8', 'muk', 'g722', 'slz', 'rhp', 'ts3_plugin', 'addressbook', 'asa', 'bel', 'slh', 'r2d', 'pgmx', 'egg-info', 'req', 'uil', 'ad_drw', 'zps', 'ffs', 'snr', 'dp2', 'qpu', 'qlpak', 'ppo', 'glx', 'eyw', 'pbc', 'isw', 'ztq', 'txvpck', 'x0w', 'tef', 'wcp_settings', 'pob', 'udi', 'mexmaci64', 'psion', 'sfl', 'md5anim', 'tinyfnt', 'keylayout', 'rf', 'acbf', 'masseffectsave', 'avpr', 'xavt', 'goz', 'fgf', 's3', 'trb', 'mfloppy', 'mdat', 'jhtml', 'efv', 'lat', 'sb7', 'wmap', 'sbxl', 'tvl', 'crplugin', 'mmms', 'lec', 'tti', 'ddm', 'g726-4', 'hwt', 'mgh.gz', 'sp5', 'vdafs', 'pzz', 'wfb', 'snz', 'ia', 'tfp', 'goomod', 'ngp', 'dsv', 'mixmeta', 'm5p', 'celtx', 'snagpresets', 'nbc', 'gi!', 'startlet', 'a3s', 't2t', 'ncmm2', 'rj', 'cs0', 'xmlbif', 'sk2', 'bsg', 'shfb', 'tcm', 'railml', 'ca5', 'vep', 'cmate', 'vlb', 'exmp', 'tb1', 'gkh', 'atdf', 'dgf', 'hpa', 'qxw', 'cbh', 'pzi', 'sqp', 'wmdb', 'abcdp', 'z81', 'rout', 'vbin', 'g721', 'snk', 'gsa', 'zpt', 'emw', 'a2d', 'lzrc', 'dtsx', 'rockwell-2', 'pset', 'dch', 'mctemplate', 'rul', 'mkj', 'pok', '2do', 'sound', 'tmmacro', 'fd', 'flag', 'amk', 'wtm', 'ssmsasproj', 'checkpoints', 'cn', 'itg', 'cgns', 'fastresume', 'moi', 'mdtxt', 'lrdb', 'ixh', 'graffle.zip', 'wvd', 'vgh', 'st11', 'smbp', 'nxt', 'lsr', '3fd', 'lm', 'rockwell-4', 'vfl', 'glossary', 'route', 'irb', 'prpreset', 'mc2', 'uv2', 'jag', 'llm', 'mhd', 'h8v', 'qtt', 'lynxsnapshot', 'states', 'lwe', 'kft', 'picon', 'txtpb', 'escn', 'qrc', 'vsr', 'a3x', 'pad', 'vvv', 'tq', 'hag', 'hpub', 'jfd', 'pib', 'edo', 'activegsxml', 'repl', 'sdlppx', 'e32', 'cddl', 'lnf', 'toot', 'ln', 'twz', 'sfa', 'rgssad', 'v2l', 'avf', 'seb', 'wbex', 'lwm', 'fem', 'dfc', 'cly', 'tar.bz2', 'o5m', 'idea', 'myapp', 'jfl', 'osm.pbf', 'ror', 'md6', 'cmsc', 'jfc', 'zingtree', 'vxm', 'ty', 'cueprofile', 'lwb', 'ufoz', 'hxr', 'nfm8', 'asdatabase', 'k26', 'phpproj', 'resources', 'silk', 'afb', 'jcw', 'fet', 'gfg', 'yst', 'lbk', 's1v', 'bba', 'tsm', 'gliffy', 'mgh', 'hocr', 'ulw', 'mcaddon', 'msn', 'vxp', 'nxc', 'mb0', 'sarl', 'rdx', 'qds', 'jxb', 'rbvcp', 'ais', 'gct', 'simt', 'dtxt', 'dclst', 'sop', 'crn', 'plmxml', 'nkple', 'df', 'chopro', 'ac3mp', 'synmod', 'ccbi', 'kawai12', 'mth', 'avrolayout', 'tpe', 'wfh', 'mvi', 'bfres', 'h8s', 'sth', 'gdv', 'ac4mp', 'szp', 'snbt', 'quiz', 'bsh', 'fwf', 'tl2', 'lra', 'lbi', 'inspxeproj', '3od', 'dsq', 'm12', 'er', 'sxt', 'noff', 'cwt', 'ai6', 'ymp', 'ifczip', 'aptx', 'szi', 'vjp', 'hpkg', 'tpa', 'nspg', 'pss', 'rsvo', 'me2headmorph', 'xiy', 'scu', 'vzw', 'pmo', '3pj', 'hsm', 'sgn', 'fq', 'hdd', 'portugol', 'sjd', 'vk', 'wdjson', 'gth', 'postbuild', 'atmo', 'av', 'xjtbz', 'mbc', 'rtbz', 'units', 'cydwr', 'dtbo', 'drummap', 'casetemplate', 'actions', 'sbq', 'sas7cat', 'redif', 'tp2', 'slxc', 't81', 'd1m', 's10w', 'pattern', 'ww5', 'td2', 'prb', 'bac', 'hws', 'shex', 'hxq', 'chords', 'rsl', 'mdsp', 'idn', 'fdoc', 'promela', 'instrument', 'ecmp', 'gbt', 'edq', 'imx', 's28', 'ntb', 'tvd', 'ppmz', 'kcx', 'pypylog', 'g726-3', 'fclr', 'setup', 'uvox', 'wrpl', 'kfr', 'rdg', 'cbu', 'inkml', 'rdlc', 'justfile', 'cv', 'htt', 'mbcfg', 'mztab', 'tsa', 'col.b', 'uax', 'ifd', 'vv', 'dcc', 'bn4', 'aheui', 'snagprof', 'plr', 'cxscript', 'unit', 'mptm', 't8s', 'tasproj', 'mcdb', 'pys', 'yadpcm', 'workspace', 'm16', 'bug', 'sal', 'phpimc', 'audio.mcf', '3dslash', 'mlv', 'wfs', 'clt', 'or2', 'nps', 'fxcfg', 'kld', 'jcm', 'ex$', 'uif', 'stdf', 'scd.gz', 'vyp', 'sfr', 'cte', 'plw', 'ss1', 'wsl', 'nvavi', 'ga', 'lmf', 'icf', 'aegraphic', '0sc', 'o01', 'wk!', 'r2z', 'savi', 'dob', 'mpak', 'sxe', 'windsproskin', 'cpsa', 'psbt', 'eof', 'nof', 'pmcq', 'procreate', 'stz', 'pwk', 'ludwig', 'prm', 'zargo', 'jverom', 'wcap', 'f32', 'hdz', 'nru', 'brainfile', 'cvr', 'riff', '3demon', 'lion', 'bcm', 'trizbort', 'minibank', 'bpp', 'cfosspeed', 'cryproject', 'sg0', 'dice', 'ir', 'ts3_style', 'hf2', 'exw', 'dam', 'tbg', 'zt', 'epl', 'ndpa', 'sdat', 'sdtid', 'ts3_soundpack', 'obx', 'xodr', '078', 'tl7', 'processedhashmap', 'lang', 'trashinfo', 'simp', 'var', 'twc', 'con', 'fzf', 'g723-5', 'mn1', 'bfl', 'btl', 'hxl', 'p2p', 'mx2', '3ad', 'w3v', 'rhl', 'bva', 'sts', 'ticr', 'lift', 'ac3sp', 'dao', 'ef3', 'spice', 'qxp_report', 'blut', 'nav', 'quox', 'ad~', 'mrcx', 'bsw', 'zsf', 'vipgrm', 'smg', 'sms', 'zwp', 'hcm', 'u255law', 'ivue', 'jdb', 'piff', 'jp', 'ofp', 'projectmgr', 'grape', 'oew', 'getviewportinfo', 'pgo', 'mra', 'scut', 'q3s', 'repx', 'phb', 'can', 'ndjson', 'scv', 'rql', 'ehpx', 'edp', 'siv', 'gsql', 'flmapping', 'lk12', 'wusiksnd', 'quad', 'magma', 'bpf', 'glj', 'lev', 'ufmf', 'ngrr', 'fev', 'tcb', 'vspx', 'godot', 'kfg', 'eww', 'nog', 'hop', 'tda', 'simss', 'px3', 'n3m', 'rqg', 'bid', 'aaruf', 'zfi', 'rpx', 'bic', 'fontspec', 'nrm', 'ezd', 'tcax', 'sbv', 'g3f', 'cbtx', 'ns2pb', 'track', 'curaprofile', 'jrsr', 'p5d', '3x5', 'identifier', 'noc', 'fcv', 'ncr', 'iom', 'ptt', 'qp', 'lsxtproj', 'fxcop', 'dip', 'xad', 'qwc', 'c2d', 'vsc', 'eqg', 'ver', 'pge', 't38', 'profile', 'wah', 'dat.h5', 'gw1', 'scattershow', 'aik', 'tpm', 'ms1', 'bg', 'ww8', 'ltd', 'inst', 'flatpakrepo', 'dsv6', 'pns', 'hcom', 'wpr', 'ldb', 'pvsm', 'f00', 'ai5', 'qtx', 'g3n', 'kik', 'akai', 'emm', 'qdtp', 'fxt', 'wksp', 'cbc', 'qcmp', 'mys', 'rqda', 'qhp', 'voices', 'audio/x-mod', 'oaz', 'ogp', 'adn', 'accda', 'gift', 'erd', 'lz1', 'o65', 'obl', 'jwcc', 'accdw', 'lsxproj', 'hts', 'ftf', 'ctr', 'rbp', 'oeaccount', 'rose', 'uxf', 'swx', 'pmpd', 't3x', 'pr0', 'bs1', 'jbeam', 'vew', 'collection', 'ai3', 'dp3']"
trid,3907,485,12.413616585615562,11544,8245,608,"['iw2', 'bio', 'xsb', 'xrm-ms', 'adu', 'mtd', 'chk', 'qlb', 'pqf', 'cxi', 'eobj', 'cinema4d', 'awlive', 'civ5map', 'tk3', 'xep', 's2a', 'ybk', 'uccapilog', 'eop', 'aswcs', 'lyx', 'xamlx', 'nmea', 'phc', 'core', 'cai', 'rwsd', 'mw2', 'dtg', 'pzd', 'xrc', 'fbrb', 'w3m', 'pando', 'amff', 'dwz', 'er1', 'frz', 'czd', 'pdm', 'xmfg', 'cmmf', 'jce', 'xdr', 'rjp', '3th', 'cwr', 'kw3', 'mws', 'loc', 'echr', 'rpp', 'paq8f', 'kfn', 'r3p', 'tkn', 'caj', 'v00', 'enc1', 'dplsave', 'xui', 'xferd', 'qx', 'fsn', 'xwp', 'haptar', 'smw', 'uti', 'ntt', 'xzp', 'mp2s', 'xdt', 'qz', 'j2b', 'nsx', 'ane', 'n2p', 'ratdvd', 'lgx', 'pcu', 'xs5', 'cc3d', 'xgs', 'ytf', 'm2i', 'dream', 'vlx', 'pvp', 'swidtag', 'ptn', 'xdd', 'mva', 'rso', 'hxn', 'xmd', 'ank', 'ebc', 'xmct', 'c10', 'xeb', 'phn', 'zfx', 'xwf', 'tngz', 'xmv', 'qzs', 'vft', 'ev2', 'wdk', 'appup', 'mcdx', 'tbs', 'dmb', 'adif', 'ofw', 'gab', 'mode2v3', 'egon', 'm99', 'ufi', 'xnk', 'rflw', 'xrp', 'gpi', 'sgriddler', 'i3f', 'xpdl', 'yka', 'tms', 'uce', 'symcache', 'uvo', 'nftr', 'nvram', 'ium', 'wdi', 'snm', 'arp', 'wz', 'apn', 'sac', 'dvg', 'cak', 'l6t', 'paq8l', 'xbs', 'nfg', 'b**', 'ipe', 'bs4', 'me3', 'ond', 'pmlz', 'd2s', 'pbxuser', 'smzip', 'xtodvd', 'jef', 'cl2arc', 'wgs', 'cdo', 'xwb', 'grz', 'lsc', 'els', '1sc', 'clmov', 'dvds', 'sgpg', 'sbw', 'bkr', 'cndf', 'site', 'brsar', 'zeg', 'erx', 'mmdb', 'cmml', 'wdg', 'pgtb', 'flipchart', 'take', 'bmu', 'nbm', 'rcad', 'hfz', 'ceb', 'mode1v3', 'kwo', 'fg', 'ypr', 'sew', 'lpaq', 'gwi', 'fed', 'vpt', 'mfil', 'st3', 'maki', 'x64', 'hjt', 'lrprev', 'istg', 'vpdb', 'xaiml', 'dpl', 'phj', 'ekb', 'mqb', 'save', 'efg', 'jcb', 'dce', 'sims3pack', 'nrkt', '8*', 'developerprofile', 'iem', 'vmlt', 'dc5', 'unr', 'nanr', 'companylogo', 'kexi', 'tku', 'st*', 'fns', 'narc', 'xtc', 'acbm', 'egrp', 'dfw', 'caproj', 'xsiaddon', 'rbxl', 'bxb', 'viivo', 'mm8', 'mqv', 'nmsv', 'grs', 'gambas', 'xbk', '8bf', 'zmi', 'qzd', 'eit', 'iws', 'epm', 'dxs', 'schlib', 'mv3', 'strm', 'ckf', 'smo', 'speccy', 'mk2', 'zno', 'gtx', 'any', 'ssts', 'crysisjmsf', 'kodu', 'pbu', 'vlcl', 'eqf', 'bvd', 'tns', 'mou', 's2m', 'gbc', 'edg', 'pvn', 'ztl', 'amw', 'stu', 'mco', 'dks', 'odv', 'zsync', 'xs3', 'ncgr', 'mft', 'shprst', 'nuv', 'kcm', 'unity3d', 'xks', 'cals', 'kws', 'pd3', 'ra3replay', 'pz', 'vp6', 'opy', 'jbi', 'ilda', 'fidx', 'wea', 'asvf', 'ncs', 'rez', 'zsg', 'ikmp', 'vthought', 'dva', 'lsim', 'xp2', 'dmm', 'xbel', 'xise', 'wdy', 'pcblib', 'xrf', 'odcl', 'ozf2', 'wwp', 'tgw', 'uci', 'btapp', 'mc4d', 'wxn', '8xu', 'frec', 'clbx', 'xpo', 'b2z', 'gvp', 'wn', 'jap', 'nr3', 'myr', 'brres', 'b5t', 'ela', 'asif', 'sdata', 'cbin', 'exm', 'xpaddercontroller', 'piv', 'glox', 'pez', 'catalog', 'mani', 'r3a', 'wyg', 'xfr', 'crysispsf', 'gau', 'sns', 'xgr', 'psy', 'hg1', 'ozv', 'wotreplay', 'cdrzip', 'tbb', 'btd', 'sims2pack', 'fd2', 'zxs', 'anbm', 'udd', 'fh*', 'eyetvi', 'xcscheme', 'nma', 'mitsu', 'arch00', 'smol', 'depot', 'rot', 'xws', 'tpg', 'ovx', 'npl', 'xfb', 'minincsf', 'xds', 'pwb', 'nclr', '8xk', 'cmd5', 'apkg', 'hlx', 'ceg', 'chesstitanssave-ms', 'ngd', 'h8t', 'pgs', 'dh', 'dcu', 'pch2', 'bav', 'hpd', 'mw4', 'b1n', 'zab', 'gocad', 'qze', 'nfc', 's2ma', 'ytr', 'btg', 'meb', 'xtr', 'apnx', 'ppv', 'w2m', 'nz', 'nm2', 'n2v', 'pumpkin', 'vmlf', 'prf2', 'fxo', 'vnt', 'paq8o', 'szx', 'oes', 'argo', 'wk*', 'mkf', 'clg', 'cdf-ms', 'xlo', 'ob3', 'stuff', 'fca', 'omfi', 'ncsflib', 'ars', 'p4x', 'wm2d', 'q1', 'qp03', 'npp', 'vcm', 'qmbl', 'psu', 'ncer', 'kz', 'sfb', 'rxf', '4cm', 'tiz', 'bgdb', 'comicdoc', 't0*', 'film', 'gq', 'sui', 'mqp', 'ilx', 'xadml', 'query', 'jsd', 'lg32', 'fbf', 'b6t', 'twf', 'ffe', 'tsc', 'sbpf', 'phr', 'blob', 'ctw', 'r2p', 'nov', 'psk', 'r2s', 'guikit', 'tlp', 'a78', 'shtmbr', '0', 'dtk', 'fdat', 'cdz', 'dwi', 'cmb', 'r2a', 'xs4']"
ffw,3777,656,17.368281705056923,15321,9000,755,"['lp3', 'pg1', 'rh', 'zp1', 'ugz', 'fyb', 'rax', 'olm', 'nrf', 'sc0', 'zck', 'nft', 'frdat', 'hostnames', 'gdx', 'lurk', 'gr7', 'tree', 'ap3', 'him', 'aq', 'nmw', 'ttp', 'rsc32', 'aclcddb-shm', 'pmn', 'mp3pro', 'imt', 'arg', 'tds', 'utp', 'qce', 'gs5', 'tpdb8', 'cdlx', 'iw', 'hjson', 'g9s', 'bts', 'hra', 'sai', 'rt3', 'pwx', 'na', 'rltd', 'xowa', 'dzv', 'z7', 'solution', 'pu', 'savf', 'plh', 'in2', 'etb', 'mvn', 'eve', 'motn', 'fec', 'sd2f', 'baka', 'aftemplate', 'cpz', 'msha', 'eup', 'rw', 'rm1', 'bos', 'motr', 'bb5', 'sb3', 'dmse', '@00', 'schematic', 'ldbst', 'zpng', 'firpiv', 'z1', 'alan', 'fiz', 'deck', 'dra', 'pixi', 'strings', 'dwm', 'frn', 'pmq', 'hbm', 'xx', 'moff', 'uhc', 'mle', 'rsndemo', 'sc?', 'hw4', 'scodl', 'ree', 'aipd', '?q?', 'jigdo', 'paq', 'disc', 're$', 'dr5', 'jpk', 'dmsa', 'phm', 't3g', 'dog', 'prism', 'ptvoice', 'bruh', 'shed', 'sfg', 'bsb.txt', 'aclcddb', 'ar7', 'i6', 'bgw', 'osgb', 'xrj', 'mwand', 'lz5', 'td4', 'jpgt', 'osd', 'psmodel', 'tsz', 'ril', 'xmit', 'ip2', 'nrt', 'wxpr', 'fyi', 'gdi', 'rdt', 'cdptz', 'dor', 'emod', 'x12', 'backup', '2dk', 'prel', 'cfi', 'vzi', 'vfc', 'ize', 'markdn', 'shielded', 'gs3', 'dma', 'pv', 'reld', 'sn2', 'moti', 'table', 'sg1', 'ows', 'nii.gz', 'gr1', 'gr0', 'iconpackage', 'xcodeproj', 'zae', 'pja', 'dgp', 'dc1', 'mars', 'gdz', 'timg', 'sid2', 'gtc', 'anmb', 'incx', 'cix', 'hss', 'bun', 'qsg', 'rm2', 'nmm', 'lispm', 'da1', '@01', 'kap.txt', 'esw', 't4g', 'acdc', 'da5', 'sbsm', 'vfx', 'oxs', 'igb', 'pspd', 'ibw', 'aussie', 'icma', 'obml15', 'backup2', 'x01', 'log1', 'p30a', 'jsong', 'unitypackage', 'pm$', 'spfs', 'wbp', 'sas7dat', 'szt', 'wrap', 'reltdemo', 'colors', 'prs.xml', 'edrw', 'idms', '4v', 'btn', 'hci', 'abw.gz', 'fmrpiv', 'unv', '1dk', 'bml', 'xcfbz2', '113', 'mur', 'ftb-wal', 'kcd', 'mfe', '$00', 'sifz', 'kbm', 'gs7', 'pxt', 'sai2', 'p50a', 'cal3d', 'rma', 'isc', 'um', 'p4i', 'dut', 'ftmm', 'rc2', 'p40a', 'imj', 'obml16', 'vig', 'npf', 'wsy', 'hw3', 'cl1', 'rsecc', 'fadein', 'nts', 'uc0', 'jgp', 'd71', 'jd', 'gr2', 'zar', 'hut', 'agp', 'ptnoise', 'c2', 'playground', 'fldr', 'ocp', 'bitsboard', 'cdu', 'cle', 'xnf', 'fcpbundle', 'qd3', 'rej', 'gwd', 'rm0', 'mpic', 'sc1', 'dio', 'mbl', 'ihe', 'seqbox', 'qim', 'deh', 'sbsar', 'bb2', 'wrp', 'zc', 'rarbase64', 'rcy', 'tbkx', 'kea', 'wll', 'prun2', 'b58', 'tlmz', 's3g', 'hfc', 'sh3p', 'rwh', 'nlx', 'gr9', 'castep', 'vo', 'reidemo', 'spb', 'tile', 'br3', 'opt*', 'cells', 'mnf', 'amp.html', 'dg1', 'param', 'mine', 'pg2', 'ftb', 'gs9', 'qcotfe', 'nil', 'sndanim', 'vw3', 'cursorfx', 'frozen.rs', 'zzz', 'fle', 'crai', '4pm', 'ipc', 'tux', 'xie', 'mshi', 'uhi', 'tud', 'ntr', 'c00', 'cdxl', 'sh3f', 'iklax', 'ftmd', 'real', 'isoimg', 'zrtf', 'tax2012', 'log2', 'rkplr', 'rm3', 'bh2pcm', 'fhm', 'odict', 'prun1', 'mcpp', 'lzd', 'osgt', 'gr9p', 'pae2', 'mvp', 'sge', '?z?', 'erlu', 'dr2d', 'vcf2', 'gr3', 'dn', 'pnd', 'fast5', 'txs', 'dvp', 'sie', 'itlp', 'ibq', 'teo', 'rse32', 'hxa', 'x??', 'mph', 'pci', 'ecdc', 'scrn', 'novabackup', 'mci', 'cex', 'nomedia', 'pm!', 'eve.exe', 'dm4', 'nwf', 'sh3t', 'vfj', 'sok', '256', 'harp', 'pdzx', 'abcddb-shm', 'warc.gz', 'wxv', 'il', 'esc', 'lzz', 'rbpack', 'z4', 'p60a', 'tax2011', 'dictionary', 'mshc', 'xkm', 'ml1', 'lxi', 'wat.gz', 'bb1', 'exc', 'cptx', 'hpx', 'afpub', 'xclass', 'gr', 'nfp', 'rm4', 'ir2', 'level', 'nxi', 'ko', 'reedemo', 'g11', 'van', 'ur2', 'device', 'tileskin', 'ucn', 'rdq', 'baf', 'ary', 'wsn', 'ecsbx', 'pdraw', 'ghg', 'dict', 'xxe', 'mzdata', 'blg', 'tok', 'dorico', 'dph', 'pnl', 'p3c', 'sef', 'library', 'sq', 'ftg', 'ben', 'bmc4', 'cl0', 'horcrux', 'chan', 'abcddb-wal', 'kwi', 'hxv', 'bbg', 'frq', 'quorum', 'gr8', 'mhp', 'br4', 'wuffs', 'abp', 'rir', 'hxc', 'kce', 'fge', 'lbw', 'hrx', 'dgk', 'hxe', 'hr2', 'ooutline', 'bs2', 'gar', 'zxt', 'dry', '??%', 'umz', 'sgo', 'da2', 'tdd', '??~', 'emn', 'obb', 'oo3', 'animated', 'sprite3', 'etar', '814', 'mpfa', 'speech', 'p40b', 'cddz', 'ssb', 'eaz', 'zax', 'hel', 'fsl', 'gs4', 'fl32', 'rki', 'backup1', 'fu', 'tlz', 'btfnt', 'p61a', 'tx0', 'dsdr', 'abex', 'mch', 'zsm', 'cfz', 'pmi', 'scptd', 'cec', 'iptheme', 'backup3', 'z2', 'abcddb', 'tgx', 'p22a', 'liz', 'ftb-shm', 'irg', 'uzed', 'sy3', 'tax2014', 'xir', 'design', 'bb0', 'wsa', 'moef', 'hrg', 'ebz', 'pbix', 'sic', 'bnsf', 'aca', 'ipn', 'wrld', 'vmm', 'nl3', 'pg0', 'demo', 'quest-save', 'ap2', 'brik', 'rle3', '1dd', 'core3d', 'hxk', 'e3d', '?01', 'vaxl', 'icmt', 'cpa', 'nwr', 'yp', 'dmcs', 'z6', 'pg3', 'apa', 'catprocess', 'vtd', 'ugoira', 'gs6', 'xsw', 'cell', 'rd3', 'asdf', 'ilc', 'vfa', 'mom', 'sir', 'efu', 'ling', 'nksc', 'epsgmod', 'minesweepersave-ms', 'g10', 'ivg', 'rkv', 'mx1', 'nlb', 't2g', 'mok', 'flh', 'jpegt', 'syj', 'obf', 'is14', 'pph', 'dpdoc', 'bcd', 'fgs', 'edifact', 'tad', 'ss4', 'zgr', 'gbproj', '4pl', 'd81', 'gs1', 'fwa', 'hit', 'etbu', 'in3', 'clh', 'pjxl', 'qoir', 'life', 'da3', 'hcrx', 'wu', 'ala', 'wa', 'aclcddb-wal', 'lwi', 'su', 'ync', 'snapshot', 'dap', 'hr', 'gs8', 'aex', 'tbpd', 'ratfor', 'dmsp', 'idtf', 'zci', 'kfp', 'fntdata', 'bek', 'cdpx', 'directory', 'jpet', 'rys', 'rcproject', 'ndtx', 'mbg', 'sprite2', 'scs4', 'bb4', 'fpw', 'locked', 'relt', 'acd-zip', 'gs2', 'sbeir', 'uns', 'lzw', 'wand', 'shb', 'flk']"
pronom,1678,72,4.290822407628129,16999,9090,90,"['w07', 'w13', 'prapic', 'w10', 'ucsf', 'e11', 'e07', 'exclude', 'ogw', 'e16', 'pbmb', 'w03', 'w08', 'e12', 'e06', 'w22', 'ega', 'w17', 'e14', 'e20', 'framemd5', 'ogmu', 'e17', 'e13', 'gcc', 'sbxls', 'e03', 'pgma', 'w16', 'w02', 'pgmb', 'opju', 'e10', 'w14', 'oggu', 'w12', 'ppmb', 'nms', 'hq.uef', 'ft2', 'w05', 'w19', 'e04', 'err', 'w15', 'w11', 'yenc', 'ft3', 'cog', 'w18', 'vml', 'w04', 'e09', 'w09', 'qxp report', 'e08', 'afi', 'ogwu', 'w06', 'e05', 'e18', 'e19', 'swatches', 'e15', 'mxi', 'qxp%20report', 'wmo', 'w20', 'vsm', 'w21', 'trn', 'src.rpm']"
linguist,1423,589,41.39142656359803,18422,9696,606,"['4dm', 'nginx', 'sexp', 'eclass', 'launch', 'em', 'xsh', 'hrl', 'bbclass', 'xsp.metadata', 'hlean', 'apacheconf', 'eam.fs', 'flix', 'xproj', 'jinja', 'csx', 'dfy', 'cuh', 'iol', 'rabl', 'emberscript', 'sublime-macro', 'ux', 'mkiv', 'workflow', 'sha224', 'lasso8', 'xsp-config', 'j2', 'edc', 'sj', 'logtalk', 'peggy', 'antlers.html', 'watchr', 'chem', 'nasl', 'xojo_code', 'ejs.t', 'slang', 'resource', 'zsh', 'mbt', 'tfstate', 'nu', 'jsh', 'r2', 'haml.deface', 'ring', 'mathematica', 'regex', 'p6', 'weechatlog', 'nse', 'gawk', 'cylc', 'vh', 'workbook', 'emacs.desktop', 'plot', 'opal', 'command', 'rpgle', 'p4', 'viw', 'rbmnu', 'rbuistate', 'mata', 'glslv', 'handlebars', 'nanorc', 'vba', 'mqh', 'cocci', 'vht', 'textproto', 'spin', 'ecr', 'duby', 'js.erb', 'bones', 'json-tmlanguage', 'uplc', 'pkgproj', 'polar', 'bicepparam', '3x', 'mirah', 'sublime-menu', 'fancypack', 'pmod', 'gsx', 'elv', 'javascript', 'ql', 'ronn', 'make', 'sage', 'pcss', 'mkvi', 'reek', 'tu', 'rnh', 'mdoc', 'snippet', 'nims', 'nproj', '9', 'livecodescript', '8xp', 'mkfile', 'vbhtml', 'regexp', 'libsonnet', 'zmodel', 'cljscm', 'xpy', 'numpy', 'cginc', '4dproject', '_ls', 'gypi', 'lektorproject', 'ndproj', 'ddl', 'muf', 'sublime-completions', 'ashx', 'marko', 'qc', 'ron', 'tl', 'html.hl', 'cy', 'editorconfig', 'cdc', 'gyp', 'sublime_session', 'hxml', '1in', 'lasso9', 'crc32', 'sjs', 'puml', 'self', 'antlers.xml', 'flex', 'sats', 'sublime-theme', 'sha384', 'xojo_menu', 'forth', 'vhf', 'hs-boot', 'xsjs', 'star', 'neon', 'xproc', 'nginxconf', 'rbbas', 'nss', 'psgi', 'curry', 'escript', 'tese', 'clue', 'lmi', 'xc', 'erb.deface', 'bzl', 'pgsql', 'sru', 'edgeql', 'ect', 'snippets', 'urs', 'rno', '_coffee', 'imba', 'pasm', 'syntax', 'jslib', '1x', '1m', 'eh', 'dircolors', 'purs', 'mdpolicy', 'fir', 'gradle', 'mly', 'lark', 'rebol', 'jav', 'overpassql', 'nearley', 'prisma', 'sarif', 'xml.dist', 'gbo', 'blade', 'raml', 'vark', 'grt', 'topojson', 'gbl', 'qasm', 'json.example', '4dform', 'intr', 'lfe', 'unity', 'hocon', 'rst.txt', 'vshader', 'yap', 'mzn', 'volt', 'sublime-build', 'ks', 'jison', 'sha3', 'mmk', 'xacro', 'mligo', 'txx', 'slnx', 'urdf', 'fshader', 'mustache', 'p6l', 'rnw', 'axi', 'ahkl', '4gl', 'tesc', 'gitconfig', 'mumps', 'brs', 'talon', 'apib', 'h.in', 'wsgi', 'nqp', 'gdshaderinc', 'kdl', 'pprx', 'c++objdump', 'oz', 'rego', 'xojo_script', 'gni', 'antlers.php', 'opencl', 'yml.mysql', 'dzn', 'epj', 'fpp', 'rbxs', 'kak', 'rbres', 'pd_lua', 'code-snippets', 'podsl', 'mtml', 'yaml-tmlanguage', 'vmb', 'tac', 'click', 'resi', 'cljc', '8xp.txt', 'props', 'd2', 'rockspec', 'toit', 'srv', 'snakefile', 'xsjslib', 'json5', 'nawk', 'coq', 'jspre', 'leex', 'njk', 'bison', 'tfstate.backup', 'sfproj', 'cshtml', 'axs.erb', 'bats', 'xrl', '3qt', 'rmiss', 'pact', 'ipp', 'hqf', 'postcss', 'tcl.in', 'clar', 'action', 'zimpl', 'nomad', 'mawk', 'ispc', 'gdshader', 'gnu', 'cmake.in', 'sail', 'pddl', 'eliom', 'svelte', 'mspec', 'cxx-objdump', 'iuml', 'sublime-keymap', 'maxhelp', 'ob2', 'scenic', 'latte', 'gjs', 'parrot', 'ktm', 'toml.example', 'plantuml', 'rbuild', 'doh', 'eliomi', 'tlv', 'ligo', 'mlir', 'xojo_report', 'es6', 'yara', 'wl', 'ejs', 'mako', 'gaml', 'prawn', 'fsti', 'cjsx', 'conll', 'code-workspace', 'sthlp', 'dhall', 'ltx', 'builder', 'mq5', 'jinja2', 'matah', 'yaml.sed', 'cats', 'creole', 'axaml', 'frag', 'lvclass', 'gto', 'linq', 'hbs', 'jbuilder', 'tfvars', 'gpt', 'sttheme', 'cook', 'yrl', 'glslf', 'templ', 'numpyw', 'iced', 'boot', '6pm', 'axi.erb', 'containerfile', 'rs.in', 'emacs', 'caddyfile', 'blade.php', 'matlab', 'sagews', '6pl', 'gdbinit', 'decls', 'vhi', 'sh-session', '_js', 'vhw', 'angelscript', 'gko', 'html.eex', 'minid', '3m', 'psc1', 'cppm', 'slint', 'xojo_toolbar', 'shader', 'cppobjdump', 'rbtbar', 'trigger', 'srdf', 'dats', 'vhost', 'cpp-objdump', 'mjml', 'sqlrpgle', 'gshader', 'religo', 'grace', 'agc', 'druby', 'vhs', 'depproj', 'jai', 'ebuild', 'hlsli', 'move', 'ne', 'smt2', 'xib', 'ihlp', 'prefab', 'mir', 'pascal', 'kojo', 'rchit', 'jte', 'cobol', 'gdns', 'jq', 'mediawiki', 'sublime_metrics', 'mysql', 'monkey2', 'tmux', 'astro', 'clixml', 'pod6', 'service', 'gql', 'http', 'ol', 'gradle.kts', '3in', 'desktop.in', 'ml4', 'inl', 'gnuplot', 'a51', 'f08', 'uno', 'numsc', 'raku', 'riot', 'sh.in', 'cljx', 'app.src', 'targets', 'sublime-color-scheme', 'hql', 'lslp', 'vto', 'rg', 'ixx', 'veo', 'sublime-commands', 'txi', 'dyalog', 'hhi', 'mint', 'razor', 'c-objdump', '3pm', 'ksh', 'sparql', 'zmpl', 'wit', 'cjs', 'prw', 'sublime-syntax', 'nr', 'oxo', 'trg', 'p6m', 'nimble', 'cirru', 'builds', 'thor', 'sublime-settings', 'ampl', 'bsl', 'zsh-theme', 'heex', 'circom', 'swig', 'livemd', 'wlua', 'pyp', 'mdwn', 'tool', 'eclxml', 'cake', 'ruby', 'vtl', 'yacc', 'nim.cfg', 'os', 'mermaid', 'auk', 'flux', 'gtpl', 'cbx', 'pegjs', 'rpy', 'ssjs', 'asn', 'pogo', 'vert', 'lookml', 'coffee.md', 'gdnlib', 'dll.config', 'ur', 'lkml', 'plsql', 'ijm', 'soy', 'hoon', 'c++-objdump', 'yasnippet', 'bbappend', 'xspec', 'tftpl', 'jisonlex', 'twig', 'hxsl', 'idc', 'gleam', 'rest.txt', 'dtx', 'tpb', 'jelly', 'cairo', 'irclog', 'eq', 'py3', 'esdl', 'wikitext', 'rdoc', 'qhelp', 'djs', 'cnc', 'pytb', 'pluginspec', 'omgrofl', 'graphqls', 'eb', '3p', 'rakumod', 'rbi', 'pyde', 'sha256sum', 'jake', 'fxh', 'webmanifest', 'ston', 'xojo_window', 'cs.pp', 'ninja', 'wxi', 'mkdn', 'axml', 'zig.zon', 'mkdown', 'd-objdump', 'aidl', 'jscad', 'asddls', 'hats', 'sha2', 'pbtxt', 'qmd', 'arpa', 'wisp', 'cljs.hl', 'yul', 'xzap', 'bicep', 'x68']"
tika,1174,252,21.465076660988075,19596,9954,258,"['jpgm', 'lbe', 'hpid', 'xargs', 'abs-linkmap', 'iso19139', 'sv4crc', 'lrm', 'osfpvg', 'sdkm', 'dcurl', 'wtb', 'adoc.txt', 'twds', 'kwt', 'kne', 'rld', 'pcurl', 'dna', 'h261', 'htke', 'igl', 'a_txt', 'cdy', 'ufdl', 'kpt', 'xo', 'keys', 'mseq', 'fh', 'knp', 'rpss', 'u32', 'sdkd', 'irm', 'davmount', 'bcpio', 'setreg', 'wbxml', 'm13', 'scurl', 'mwf', 'h263', 'distz', 'ecelp7470', 'seed', 'install', 'c4g', 'qam', 'mpm', 'link66', 'xlog', 'anpa', 'gac', 'c4u', 'ft12', 'xlex', 'emma', 'plf', 'ecelp9600', 'itp', 'dist', 'mmpt', 'mpg4', 'ifm', 'gram', 'xroles', 'sema', 'skt', 'fh40', 'dataless', 'les', 'xbd', 'jlt', 'ihtml', 'nns', 'ptid', 'egrm', 'fhc', 'cdbcmsg', 'xenc', 'cdkey', 'teacher', 'ufd', 'jx', 'aso', 'tcap', 'semf', 'asnd', 'zirz', 'nlu', 'dfac', 'susp', 'wmlsc', 'boz', 'wsdd', 'xsamples', 'mp2a', 'fh12', 'zaz', 'maker', 'clkw', 'ez', 'cwiki', 'uri', 'sldx', 'grb1', 'oas', 'mp4s', 'tmo', 'kfo', 'ktr', 'mpga', 'xgrm', 'zmm', 'pclxl', 'eol', 'ocaml', 'flw', 'ad.txt', 'btif', 'clkp', 'uoml', 'wspolicy', 'junit', 'latex', 'pen', 'unityweb', 'frame', 'fh50', 'wmlc', 'spot', 'pkipath', 'cii', 'classpath', 'fzs', 'acutc', '.htaccess', 'curl', 'roles', 'gre', 'clkt', 'chrt', 'fg5', 'ecma', 'xpx', 'odft', 'bh2', '3dml', 'deploy', 'nnw', 'umj', 'xmap', 'mmat', 'urls', 'rms', 'p7r', 'sus', 'amfm', 'karbon', 'semd', 'ecelp4800', 'chat', 'efif', 'msty', 'bpk', 'gqs', 'x32', 'jpgv', 'mp4v', 'tpt', 'et3', 'setpay', 'rdz', 's_txt', 'readme', 'oda', 'portpkg', 'xcat', 'fv', 'xweb', 'clkk', 'xop', 'oa2', 'mqy', 'sv4cpio', 'onetmp', 'shf', 'xegrm', 'atomcat', 'rnx', 'nnd', 'abs-menulinks', 'mcurl', 'rpst', 'mpy', 'kia', 'xhvml', 'xld', 'oprc', 'mmmp', 'xslfo', 'uris', 'acfm', 'rcprofile', 'grm', 'ivp', 'gtw', 'wmls', 'restx', 'csml', 'xwelcome', 'rtx', 'list3820', 'xvm', '^rdf$', 'mscml', 'xvml', 'ghf', 'listafp', 'wqd', 'pvb', '*-gz', 'gex', 'mpe', 'gqf', 'mmas', 'lostxml', 'mseed', 'oa3', 'kon', 'joda', 'i_txt', 'daf', 'c4f', 'lbd', 'sse', 'aart', 'etx', 'c4p', 'hbci', 'qps', 'itk', 'sfd-hdstx', '^owl$', 'mp4a', 'xpw', 'xconf', 'slt', 'hvp', 'ei6', 'ngdat']"
file,736,79,10.733695652173912,20332,10035,81,"['__d', 'ful2', 'xoj', 'aup3-shm', 'sqlite2', 'bcstm', 'xis', 'j01', 'wxx', 'db3-shm', '$xe', 'trc0', 'srd-shm', 'pp_', 'dbx-shm', 'wc', 'gxc', 'mrs', 'ja', 'bcwav', 'help', 'rmeta', 'ntfs', '?$', 'j02', 'asar', 'profm', 'grib', 'xia', 'rgn', 'fxx', 'pe5', 'wsb', 'pmv', 'hwpx', 'irs', 'sysex', 'upk', 'iso9660', 'maple', 'deskthemepack', 'pwz', 'bmk', '?_', 'pkd', 'framemif', 'trc1', 'uwl', '_', 'imgc', 'kicad_sch-bak', 'w40', '3gr', 'stex', 'divx', '008', '012', 'hwl', 'bfstm', 'dc42', 'gkb', 'clamtmp', '$ts', 'kicad_pcb-bak', 'cdrt', 'tr1', 'fj3', 'jsbundle', '18', 'wt4', 'grib2', 'dbe', 'dbpf', 'nod', 'icsalarm', 'xbt', 'aria2', 'vbox-extpack', 'a68']"
naradpf,590,51,8.64406779661017,20922,10090,55,"['utf8', 'ole', 'jtip', 'sdxf', 'others', 'connected node spatial index', 'x-mp3', 'mpeg2', 'x-mpeg2a', 'a86', 'x-mpegaudio', 'bl', 'sunras', 'pip', 'wrl.gz', 'csi', 'm2p', 'service.lck', 'autorun.inf', 'frontpg.ini', 'dl_', 'zdct', 'ole2', 'mp2p', 'temp', 'rt#', 'frontpg.cnf', 'dht', '0xx', 'l16', 'mp2t', 'utf', '3gg2', 'utf16', 'xhtm', 'qta', 'primitive', 'x-pn-mpg', 'x-mpg', 'l41', '3gp2', 'mpeg3', 'mp1s', 'x-mpeg3', 'plain_text', 'x-mpeg', 'frontpg.lck', 'mdm', '10', 'bkl', 'ft#']"
lcfdd,487,45,9.240246406570842,21409,10135,45,"['wkt', 'atmos.audio', 'par3', 'df0', 'enlp', 'lx01', 'pt24', 'bipw', 'b3dm', 'sec', 'df4', 'pnts', 'not applicable.', 'ptif', 'df2', 'ws2', 'ppc', 'xhe', 'bfm', 'df9', 'cmpt', 'damf', 'atmos', 'jmh', 'df5', 'rcw', 'vrm', 'doq', 'rlcw', 'map.xml', 'rar ', 'i3dm', 'df6', 'loas', 'hdfeos', 'tar.gz', 'df8', 'atmos.metadata', 'bmpw', 'mxmf ', 'pth', 'slpk', 'ex01', 'df7', 'bsqw']"
tcdb,190,29,15.263157894736842,21599,10164,29,"['.rls', 'fm5', 'snx01', 'ftsc', 'ftds', 'qsc', 'qpl', 'ftwp', 'pm7', 'fttb', 'ftop', 'wkn', '.ep', 'qpc', 'rrs', 'ftpc', 'eqn', 'pict, pic', '.pun', 'ssp01', 'px1', 'ssd01', 'cid', 'ap1', 'ssv01', 'fht', 'nzl', 'fatp', 'sct01']"
tffh,125,2,1.6,21724,10166,2,"['g##', 'pgl']"
mediainfo,46,2,4.3478260869565215,21770,10168,2,"['mpgv', 'irca']"
