source,num_exts,num_uniq_exts,percent_uniq_exts,total_exts,total_uniq_exts,added_uniq_exts,uniq_exts
wikidata,7628,2299,30.138961719979026,7628,7628,7628,"['amm', 'omr', 'nrb', 'w2w', 'mkb', 'sw2', 'age', 'sil', 'idea', 'ifs', 'qmc', 'cbu', 'zvi', 'tal', 'spider', 'mfi', 'bna', 'bp1', 'vdu', 'graph', 'awebplugin', 'nog', 'bf2', 'ed5', 'nrm', 'mn9', 'dulk', 'tmb', 'wproj', 'color', '3dv', 'pa2', 'cc1', 'rockwell', 'cde', '078', 'lwb', 'asb', 'pimg', 'edo', 'd.ts', 'dv-avi', 'exo', 'rvd', '3gpp2', 'nbc', 'compiled', '_01', 'dfpwm', 'sltx', 'sxe', 'fmu', 'vtm', 'mse', 'spi3d', 'sms', 'bid', 'sal', 'pwdump', 'vk', 'ncm2', 'rbxlx', 'processedhashmap', 'psq', 'etc', 'ahu', 'ms3', 'jp', 'nrd', 'senc', 'hiof', 'rs5', 'lpaq1', 'emu', 'ezd', 'btl', 'zx', 'txk', 'tmod', 'scattershow', 'sngbase', 'dfd', 'jse', 'ltm', 'umx', 'ad_drw', 'vxm', 'jba', 'qds', 'algobuild', 'ep1', 'ccb', 'tke', 'yrr', 'prl', 'crplugin', 'slf', 'ndk', 'uasset', 'qbe', 'ccz', 'idsp', 'jwcc', 'synw-snippet', 'ac4', 'mwd', 'tl2', 'kmn', 'wfbe', 'ispro', 'ecd', '3dn', 'sul', 'sk2', 'df', 'can', 'jslt', 'pgmf', 'sfl', 'vgh', 'atl', 'gof', 'fow', 'rwt', 'cmsc', 'mb1', 'g726-2', 'sdz', 'phyloxml', 'bn4', 'mcworld', 'bare', 'eka', 'kr1', 'sxz', 'clz', 'fph', 'sbl', 'ac4sp', 'symmod', 'datgr', 'aat', 'opl', 'nvavi', 'obl', 'rproj', 'ede', 'cwy', 'wlf', 'gitmodule', 'users', 'g726-5', 'smdevice', 'cjr', 'pmtiles', 'promela', 'eg', 'ai5', 'itx', 'dcls', 'vjsproj', 'lynxsnapshot', 'rdo', 'video.mcf', 'route', 'smufi', 'adobebridge', 'mlappinstall', 'dat.h5', 'accda', 'kv6', 'sqp', 'gossett', 'uis', 'pmdriver', 'repx', 'mvi', 'bsg', 'fex', 'ftf', 'wxm', 'coords', 'ghx', 'isa', 'g1a', 'tax2008', 'tv1', 'nsz', 'share', 'msixbundle', 'xjtbz', 'rhl', 'dclst', 'hcm', 'ridl', 'dfa', 'axp', 'mzmlb', 'import', 'msn', 'islands', 'psg', 'uproject', 'sob', 'vvi2', 'icspkg', 'qlpak', 'wk', 'snz', 'ei', 'audio/x-mod', '4d', 'ufnt', 'val', 'vex', 'fogui', 'slrnrc', 'hpr', 's24', '6pk', 'rcf', 'col.b', 'o65', 'vrscene', 'apks', 'cx', 'brainzip', 'kcmsf', 'o01', 'tasproj', 'sgp', 'jex', 'tl4', 'crv3d', 'g722-7', 'dmkit', 'cast', 'gwb', 'ligt', 'squid.conf', 'lgf', 'hti', 'scrpt', 'mmcif', 'ymp', 'zpr', 'a3x', 'm4s', 'gdv', 'unit', 'cib', 'cvcert', 'newick', 'tprops', 'arexx', 'stproj', 'rdbdata', 'sdtid', 'cgl', 'ngp', 'sbox', 'cwt', 'cc2', 'tb1', 'svar', 'ppo', '0sc', 'afb', 'w8v', 'xjt', 'roz', 'spi1d', 'zda', 'g2w', 'kvk', 'sql.jinja2', 'mhd', 'ac4mp', 'pns', 'vpo', 'dzprj', 'wet', 'mgh.gz', 'flag', 'palm', 's1a', 'uht', 'lxt', 'rcm', 'ebs', 'gvimrc', 'rvc', 'itg', 'nbattrs', 'escn', 'ps2', 'sup', 'uvprojx', 'lsmv', 'meson.build', 'treetop', 'idn', 'iap', 'mrcx', 'avchd', 'egg-info', 'edv', 'pecom', 'fxcop', 'or4', 'smb', 'drawing', 'zf3d', 'fve', 'kbe', 'qtk', 'sog', 'desksoftlicense', 'lqm', 'scheme', 'duckdb', 'f4b', 'mrx', 'pqo', 'rgd', '3dw', 'ezpx', 'mn6', 'hxw', 'txp', 'emw', 'rul', 'dtxt', 'ppmz', 'qhp', 'ivue', 'g723', 'qwc', 'ia', 'tnfo', '2dm', 't0ast', 'tti', 'bnf', 'fix', 'pattern', 'exec', 'dmo', 'lcry', 'amplxeproj', 'stz', 'psym', 'clt', 'txtpb', 'wtf', 'bll', 'nktrl2_data', 'eywx', 'ioc', 'ms1', 'ns2p', 'ktp', 'lgr', 'hexdwc', 'mce', 'gchone', 'pvt', 'drr', 'paln', '005', 'nx5', 'ga', 'kfg', 'kpj', 'bb6', 'windsproskin', 'inv', 'color1', 'tsi', 'jfl', 'generictest', 'gw2', 'dxfp', 'corgr', 's1v', 'sdlppx', 'qlr', 'tcb', 'jui', 'civ5sln', 'pjm', 'trashinfo', 'camm', 'xgl', 'wmlf', 'wadl', 'aer', 'g723-5', 'eui', 'phst', 'music', 'mvpl', 'quiz', 'tivo', 'nof', 'vsc', '3sd', 'dice', 'vlb', 'mwdeck', 'tch', 'bbc', 'tsa', 'noc', 'mii', 'jpg2', 'qtvr', 'fdneut', 'exmp', 'lmf', 'acro', 'watchface', 'fq', 'sab', 'ufp', 'ymap', 'mn8', 's8theme', 'kx', 'tef', 'bco', 'lift', 'yay0', 'wpx', 'kam', 'ncm', 'gsa', 'eof', 'hle', 'rtp', 'qxw', 'sets', 'juttle', 'phpimci', 'c--', 'luacodec', 'g3n', 'nop', 'tfe', 'vet', 'ai6', 'cbh', 'efq', 'ytyp', 'yst', 'dtbo', 'qvto', 'csdl', 'cwa', 'itn', 'mapx', 'vsr', 'shd', 'owx', '3ad', 'e4i', 'dfdl.xsd', 'ekc', 'mcpack', 'cedf', 'gtkw', 'lc', '32', 'casetemplate', 'hcom', 'resmoncfg', 'ndpi', 'slz', 'jsxinc', 'hsail', 'oom', 's28', 'llm', 'keylayout', 'scg', 'soft', 'audio.mcf', 'dtsconfig', 'ttb', 'comx', 'qcow3', 'g3w', 'p5d', 'lia', 'pgo', 'd07', 'accdc', 'pmcq', 'mb0', 'pkt', 'zlx', 'uplugin', 'f32', 'uvox', 'aweblib', 'sqlite3-console', 'fev', 'adn', 'mtc', 'xodr', 'n3d', 'bfres', 'tvd', 'vmu', 'osn', 't@0', 'pbl', 'rbvcp', 'mexa64', 'jverom', 'vfl', 'the', 'wsl', 'hsm', 'dewf', 'ctc', 'nkple', 'dhw', 'qr2', 's1', 'mexmaci64', 'rho', 'vjp', 'vproj', 'dsq', 'spg', 'cok', 'kawai12', 'bra', 'textclipping', 'qxp_report', 'fzf', 'awses', 'lav', 'ely', 'w2a', 'f1q', 'mphtxt', 'setup', 'ftlx', 'd06', 'lgl', 'sg0', 'rockwell-4', 'cs0', 'ad~', 'oleo', 'stencyl', 's3', 'jsrc', 'h8s', 'jbeam', 'zt', 'sunsynth', 'tkp', 'monopic', 'dmr', 'ayl', 'pprj', 'aren', 'mwm', 'shfbproj', '2do', 'rco', 'pbiviz', 'lwm', 'zco', 'battle', 'tmc600', 'cfosspeed', 'fzv', 'tg', 'perlapp', 'tbgn', 'gtr', 'sparseimage', 'cbc', 'sgr', 'vdproj', 'uai', 'simss', 'bac', 'sf2pack', 'udi', 'vsps', 'rua', 'country', 'nxt', 'exi', 'mn3', 'pio', 'gguf', 'lpkg', 'wmap', 'amgp', 'pd~', 'frc', 'm3f', 'xsz', 'bxrc', 'eda', '2d', 'rdlc', 'lzt', 'typelib', 'lat', 'sur', 'ztt', 'lzrc', 'tdms', 'dp3', 'rf', '404', 'postbuild', 'x3a', 'avf', 'qxcf', 'riff', 'lbk', 'gi!', 'pss', 't88', 'mrv', 'pok', 'aue', 'tri', 'mldf', 'gfg', 'ts3_addon', 'mbz', 'mvdx', 'snagprof', 'clc', 'accdt', 'bifxml', 'lgc', 'mbcfg', 'bug', 'identifier', 'pagx', 'lbrn', 'oxp', 'fm2', 'bsw', 'ppmz2', 'jfc', 'xsf', 'ogex', 'adsklib', 'bashrc', 'ai3', 'mwsymb', 'gff3', 'era', 'efk', '6pack', 'nq', 'kcx', 'meta4', 'tv3', 'jdb', 'wmdb', 'rockwell-2', 'vuze', 'gplt', '3sl', 'ci6', 'enf_abq', 'v3m', 'ver', 'l3k', 'demset', 'hls', 'wbex', 'collection', 'iti', 'wusikpack', 'apg', 'm10', 'ts1', 'ric', 'anm2', 'yra', 'rtbw', 'jcf', 'nom', 'ydr', 'hewsp', 'cho', 'lm', 'lion', 'yadpcm', 'freshroute', 'pbj', 'sas7cat', 'hrc', 'lvlps', 's19', 'x0w', 'sn4', 'ba8', 'rmr', 'sunvox', 'lth', 'sbmi', 'pkinfo', 'fconfig', 'arrow', 'cqe', 'ef', 'nsla', 'rwo', 'nxc', 'c01', 'incgr', 'rj', 'tmt', 'hotlist', 'meg', 'g722-8', 'sjd', 'lgd', 'mclib', 'rsl', 'pr0', 'syf', 'nex', 'lwe', 'cueprofile', 'pvl', 'ispac', 'emm', 'pxe', 'ticr', 'sfa', 'wvd', 'instr', 'hgd', 'igf', 'i90', 'ba2', 'ubb', 'cdi', 'tasm', 'w7v', 'avpr', 'f3r', 'ufmf', 'pyz', 'or2', 'k3g', 'cscheme', 'glo', 'cjm', 'motivi', 'rlv', 'muk', 'brl', 'goomod', 'jwp', 'inspxeproj', 'spmod', 'ncr', 'asdatabase', 'mdu', 'strokes', 'kmap', 'ade', 'lisaem', 'u255law', 'rpk', 'bic', 'ueb', 'cmate', 'jxb', 'ids2', 'wke', 'zargo', 'profile', 'kk3', 'tarc', 'exrc', 'pb0', 'batch', 'dao', 'wfc', 'ovd', 'rqg', 'bec', 'avroskin', 'signal', 'pmpd', 'hmd', 'tmmacro', 'hop', 'cly', 'mfv', 'uvp', 'tfp', 'si3', 'ulz', 'mlx', 'phb', 'mh', 'wah', 'lrt', 'eed', 'kp', 'gsql', 'arb', 'map2video', 'jag', 'sbxl', 'srcinfo', 'ymt', 'pge', 'mux', 'ztq', 'bfd', 'laa', 'apkm', 'ac3sp', 'cor', 'ms2', 'mplog', 'ppl', 'nbz', 'r2d', 'mn1', 'object', 'ktf', 'mwv', 'vin', 'sbsasm', 'lsa', 'qxf', 'gmsynth', 'tbh', 'gle', 'wksp', 'psntemplate', 'hwa', 'dx7', 'epx', 'trig', 'dtq', 'mrlv', 'aft', 'psion', 'vsb', 'rpz', 'pdu', 'sox', 'mof', 'stng', 'stencil', 't06', 'mwproj', 'pup', 'rw1', 'ydd', 'simmeshdb', 'ty', 'phone', 'uqm', 'fdoc', 's10w', 'rde', 'emailcache', 'binpb', 'fmc', 'qp', 'ldl', 'jzlib', 'eqg', 'nqc', 'xtm', 'nbt', 'xcconfig', 'kfr', 'mdn', 'pseg', 'pfdc', 'lrr', 'mdat', 'pjx1', 'pop.ncdf', 'tvl', 'skel', 'vxp', 'psci', 'hnt', 'ssw', 'foguischeme', 'xly', 'swx', 'sitemap', 'tda', 'exdg', 'alpha', '4mu', 'tvn', 'ubz', 'cnsf', 'bash_profile', 'v64', 'zw', 'mha', 'hsn', 'wmal', 'qrc', 'nist', 'dsv6', 'hdz', 'mmv', 'scb', 'pzs', 'm11', 'qef', 'odx', 'ytt', 'con', 'zipe', 'bpp', 'lrdb', 'masseffectsave', 'ixh', 'bfont', 'g726-3', 'tcax', 'cvz', 'lyz', 'ml2', 'n64', 'glj', 'btc', 'savi', 'tpy', 'oeaccount', 'sla.gz', 'lsr', 'vfn', 'gbm', 'alf', 'fbp', 'rql', 'ori', 'bbl', 'hws', 'vwl', 'tpc', 'lsxtproj', 'wk!', 'smdlproj', 'esps', 'ex$', 'ytd', 'h8v', 'ptls', 'edq', 'mpex', 'gel', 'z64', 'pib', 'psmdcp', 'accdr', 'qdat', 'fbd', 'vault', 'ngb', 'mips', 'cg3', 'upj', '3da', 'wfp', 'oew', 'vspx', 'hsh', 'x3w', 'plw', 'vbin', '3dsx', 'wtm', 'edmx', 'ssdl', 'xtl', 'mt5', 'dfc', 'rln', 'dsu', '3od', 'cry', 'pob', 'cdv', 'dtsx', 'gdc', 'hbw', 'sbj', 'wbdp', 'ctr', 'xjb', 'zingtree', 'efv', 'pad', 'seexpl', 'geodatabase', 'gth', 'kdevses', 'ffs', 'w7a', 'gxml', 'fastresume', 'ebf', 'atdf', 'ww8', 'scy', 'epc', 'fef', 'elpi', 'maql', 'justfile', 'sp3', 'mx2', 'moi', 'lbo', 'qxi', 'rmtl', 'sue', 'wpr', 'amk', 'fmg', 'uvn', 'dgf', 'mvt', 'stmx', 'ovs', 'z_t', 'h5rage', 'wusiksnd', 'zdb', 'uidl', 'attachment', 'pvsm', 'workspace', 'r2r', 'fgeo', 'ca5', 'ir', 'qdtp', 'ts3_plugin', 'mnx', 'mi', 'brep', 'bssc', 'grc', 'hxi', 'bs1', 'provbank', 'dyn', 'units', 'ogp', 'ntb', 'lzham', 'typoscript', 'syv', 'tn5', 'scv', 'rita', 'wizard', '0fn', 'svt', 'mspxml', 'nhd', 'utk', 'edt', 'vt2', 'hxl', 'mma', '3bd', 'c3t', 'wme', 'fb3', 'pau', 'fasm', 'kim', 'mlv', 'skchr', 'siv', 'l86', 'dylan-console', 'xvy', 'shortcuts', 'umlclass_diagram', 'vek', 'nspg', 'qhcp', 'architect', 'rsf', 'smg', 'bva', 'instrument', 'fxcfg', 'elev', 'mythsav', 'm16', 'vpc', 'ymv', 'zwp', 'tar.bz2', 'g721', 'p2p', 'asec', 'tzf', 'scu', 'mapcss', 'aii', 'hag', 'mrxs', 'tup', 'vep', 'wap', 'ybn', 'mz5', 'bel', 'hwt', '3demon', 'dcupdate', 'btsearch', 'gw1', 'seb', 'txvpck', 'alv', 'scut', 'gor', 'x0a', 'pop', 'xjtgz', 'pbs', 'tah', 'enpack', 'ppkx', 'wibucmrau', 'hma', 'a8k', 'qop', 'rtbz', 'ds3', 'tiger', 'dub', 'kdelnk', 'acbf', 'quox', 'ovpn', 'oht', 'ahs', 'tv6', 'pmo', 'groupproj', 'blif', 'iom', 'gise', 'folders', 'kva', 'xtd', 'prom', 'u00', 'adlib', 'ffxml', 'phpimc', 'cqm', 'e32', 'rnqs', 'o5m', 'abicollab', 'simp', 'jtf', 'coasts', 'wcap', 'pixexp', 'streamdb', 'jiff', 'trace', 'plmxml', 't2', 'mcaddon', 'bez', 'sn3', 'reqifz', 'w7w', 'a4w', 'ofn', 'zpt', 'gift', 'xiy', 'exx', 'hnm', 'f64', 'hhe', 'asr', 'cow', 'wsi', 'ugf', 'qmv', 'ncmm2', 'tq', 'afw', 'animl', 'caq', 'mktx', 'twx', 'g726', 'vfproj', 'h4r', 'vs1', 'bpf', 'lut', 'wdiff', 'libzip', 'sqlplan', 'drawlog', 'bsh', 'rgf', 'efs', 'ltn', 'pro6', 't3x', 'dbh', 'ppz2', 's1m', 'mn5', 'weba', 'eth', 'uxf', 'pnproj', 'tsd', 'states', 'brw', 'tl1', 'vew', 'rpak', 'ptt', 'motif', 'lbi', 'sak', 'lev', 'stdf', 'amod', 'tbmat', 'bky', 'chq', 'atmo', 'omdoc', 'osim', 'usb', 'mcdb', 'hcs', 'ewp', 'ha2', 'nhf', 'pmml', 'dam', 'kn', 'yft', 'ta8', 'smiles', 'ggpk', 'wpp', 'borders', 'rdx', 'd5p', 'pypylog', 'mdsx', 'snk', 'dgm', 'wcp_settings', 'gdiff', 'ulw', 'at', 'gdg', 't27', 'itmx', 'spm', 'g722', 'mixmeta', 'brseq', 'yaz0', 'ts3_style', 'materials', 'dsg', 'ssmsmobileproj', 'coff', 'wtt', 'hdprg', 'qtx', 'igtx', 't29', 'jwpub', 'ldp', 'godot', 'spbm', 'spt', 'kvt', 'cs1', 'd08', 'rwe', 'noff', 't81', 'm5p', 'tp2', 'wlnet', 'mn2', 'sbp', 'inst', 'viz', 'pys', 'pew', 'bcm', 'y3d', 'mze', 'fpc', 'rxt', 'vef', 'ed6', 'xorg.conf', 'bfl', 'crn', 'hdc', 'dxn', 'masm', 'xdf', 'or3', 'ns2pb', 'zx1', 'gaz', 'tbg', 'epv', 'fdxt', 'bis', 'jdp', 'txvactivitydiagram20', 'hsd', 'bx', 'ema', 'hse', 'blc', 'sck', 'npw', 'aexpk', 'pbh', 'qpu', 'jucer', 'fhs', 'wfb', 'smgxml', 'bbmodel', 'ltw', 'aria', 'xpp', 'gliffy', 'epl', 'eu4', 'mus10', 'sdlproj', 'r2z', 'sg4', 'a8t', 'jma', 'fbp4', 'projectmgr', 'amp', 'glossary', 'arpbank', 'cpsa', 'mctemplate', 'bsx', 'atp3', 't8s', 't8c', 'qba', 'wdjson', '3pj', 'wire', 'dda', 'ccbi', 'spw', 'nnb', 'drummap', 'gmod', 'blsc', 'skba', 'nexus', 'aglib', 'avl', 'hdd', 'tin', 'jhtml', 'sobj', 'pnps', 'dhp', '3wd', 'pro4', 'brainfile', 'dpal', 'ccw', 'tibkp', 'jsa', 'addressbook', 'starpak', 'joc', 'aprx', 'dsv', 'imx', 'wfl', 'myapp', 'csg', 'vipgrm', 'fmi', 'd4m', 'jcw', 'if', 'jem', 'bigbed', 'bmfc', 'dcc', 'rvdata2', 'gthr', 'hck', 'gxt', 'mfloppy', 'ufr', 'lproj', 'fxt', 'gcl', 'an1', 'curaprofile', 'pnws', 'ffs_gui', 'dr8', 'spl7', 'vdafs', 'pubxml', '4dosav', 'lnd', 'dtt', 'reqif', 'hhb', 'chopro', 'ror', 'szi', 'wskn', 'xavt', 'snbt', 'ufoz', 'pr', 'wacomxs', 'htt', 'rpa', 'psbt', 'cte', 'nginx.conf', 'cmarkers', 'goz', 'lnarc', 'elas', 'fclr', 'vvv', 'dmptrn', 'jrsr', 'gct', 'pvi', 'ckit', 'c3p', 'sbv', 'pvc', 'ste', 'aibb', 'bbz', 'bphys', 'abcdp', 'itc2', 'aln', 'nps', 'wrpl', 'abbu', 'mpr', 'dec', 'xav', 'rrr', 'rwm', 'dri', '4dff', 'inrs', 'mc2', 'efa', 'h6v', 'cac', 'mra', 'sarl', 'bmsk', 'dj', 'ldb', 'o5c', 'hld', 'pfcolors', 'ndjson', 'td2', 'in2d', 'fgf', 'sfarr', 'snr', 'ckb', 'publishproj', 'avrolayout', 'schrepx', 'promql', 'ejpg', 'isw', 'unif', '264', 'w2ent', 'ipsw', 'tek', 'ig4', 'gltth', 'evoque', 'songsmith', 'itw', 'eqconfig', 'ltp', 'xiz', 'sca', 'yace', 'pn', 'kdevprj', 'spice', 'fdm_material', '3dslash', 'c2d', 'quad', 's7i', 'hpub', 'bba', 'd3plot', 'rhp', 'b2s', 'lwh', 'ion', 'osm.pbf', 'cryproject', 'md6', 'pb1', 'settings', 't38', 'module', 'md5mesh', 'fg4', '3dp', 'hf2', 'omt', 'wcst', 'rfg', 'fbr', 'pwk', 'ltd', 'hyb', 'mixstatus', 'ad_prt', 'pkf', 'opam', 'ava', 'ocs', 'mcschema', 'lcf', 'gbxml', 'pzw', '3dmbak', 'pcsav', 'mkr', 'svn', 'nrh', 'nx4', 'ubj', 'yop', 'jcm', 'file', 'l3b', '3dmlw', 'ngrr', 'hxq', 'mwz', 'tpa', 'chords', 'mmx', 'beancount', 'att', 'ngs', 'ta7', 'vtml', 'rawvox', 'gchord', 'hrm', 'usx', 'pbc', 'fontspec', 'tinyfnt', 'frinika', 'rpmsg', 'oaz', 'bsearch', 'mc3', 'loadtest', 'material', 'gff', 'dsx', 'sbq', 'lot', 'av.mcf', 'pysu', 'gef', 'slh', 'g726-4', 'cae', 'omg', 'vzw', 'sndr', 'axg', 'lra', 'jsgf', 'phpproj', 'lk12', 'epsg', 'ftlh', 'cromfs', 'portugol', 'torsion', 'bkd', 'teal', 'qvs', 'lhw', 'daw', 'wph', 'image/nie', 'sgv', 'sad', 'v4p', 'wan', 'chart', 'rpd', 'f1d', 'singularity', 'si4', 'zan', 'aheui', 'wl1', 'wprops', 'htaccess', 'genh', 'pse', 'exw', 'xd', 'mbc', 'tpm', 'trizbort', 'vqa', 'ghlayout', 'gy', 'wgm', 'jml', 'rose', 'iqt', 'stapl', 'emx', 'eww', 'lzu', 'lb6', 'pmbc', 'ride', 'nklm', 'plr', 'bntx', 'ezf', 'toot', 'ddm', 'cfw', 'ao', 'e4xmi', 'zook', 'wfs', 'uv2', 'spayd', 'klc', 'wpf', 'html-wp', 'rem', 'stj', 'pie', 'udn', 'lec', 'mwk', 'req', 'xsym', 'mogrt', 'edml', 'camp', 'rockwell-3', 'mjt', 'w3v', 'dp2', 'grfx', 'fabbproject', 'pset', 'hip7', 'anme', '1tl', 'xdv', 'g6', 'pdw', 'tmv', 'ad_asm', 'mn7', 'mth', '64c', '🔥', 'edk', 'wwu', 'fc3map', 'ev3e', 'ldjson', 'rac', 'tcm', 'twz', 'bdd', 'iw5dlc', 'tiencr', 'vbox-prev', 'repl', 'empo', 'uvd', 'jfd', 'al2', 'safetensors', 'bpi', 'database', 'bop', 'glksave', 'pzi', 'rwd', 'mmb', 'mcm', 'pzz', 'mobirise', 'cgc', 'os6', 'ehpx', 'sep', 'pbb', 'synw-proj', 'aptx', 's3o', 'pwr', 'swe', 'hpt', 'fem', 'abdata', 'winmd', 'cbtx', 'uax', 'st0', 'dre', 'srp', 'qdt', 'kct', 'pcam', 'zlic', 'vv', 'obx', 'cyg', 'jspf', 'apj', 'pgmx', 'taml', 'jed', 'magma', 'acre', 'bg', 'jic', 'railmlx', 'fchk', 'xpz', 'qxmt', 'mn4', 'lang', 'pa1', 'mixindex', 'resources', 'vscn', 'nbs', '2hd', 'b4a', 'p86', 't77', 'g3f', 'nk', 'cvl', 'var', 'arl', 'rgssad', 'txvclassdiagram20', 'iinv', 'tr2', 'tscproj', '1pif', 'zu', 'vpf', 'asa', 'fwf', 'sment', 'mji', 'psess', 'erwin', 'uvopt', '3fd', 'qct', 'sgz', 'ontx', 'x3v', 'snt', 'vgr', 'etv', 'prm', 'lz1', 'rbp', 'zpj', 'aal', 'dbox', 'gabc', 'copc', 'mkj', 'fprops', 'mjl', 'dsres', 'hcxs', 'getviewportinfo', 'ifd', 'ssmsasproj', 'psn', 'nja', 'mztab', 'demi2', 'uif', 'bfsar', 'piff', 'ai4', 'rsct', 'uml', 'hns', 'rx', 'mpkx', 'myf', 'msix', 'gbt', 'lwc', 'psl', 't07', 'ha12', 'c2pa', 'dg', 'gc', 'mel', 'fmo', 'sfr', 'dprops', 'omp', 'glx', 'rw3', 'ptu', 'flmapping', 'spz', 'poly', 't08', 'fc0', 'wwd', 'znc', 'st11', 'brfnt', 'startlet', 'kxf', 'adw', 'ntx', 'a2d', 'cnm', 'srec', 'zsf', 'er', 'ofl', 'htpasswd', 'shfb', 'dsi', 'cee', 'v2l', 'simt', 'idx2', 'iwl', 'csy', 'xad', 'ruleset', 'uil', 'lsg', 'mlpkginstall', 'remotemap', 'akai', 'tox', 'ais', 'cv', 'xmlbif', 'tq2', 'eyw', 'mfa', 'lv', '2bit', 'jos', 'odttf', 'unf', 'xbv', 'gbf', 'wfh', 'ev3b', 'state', 'irb', 'cddl', 'ss1', 'hod', 'msstyles', 'sppack', 'vj', 'arduboy', 'mbtiles', 'prb', 'zps', 'bvy', 'dja', 'oprops', 'sel', 'ai7', 'mqf', 'snagpresets', 'rff', 'ssx', 'vvp', 'slxc', 'ivml', 'oap', 'mphbin', 'syo', 'nfm8', 'kcw', 'indk', 'snobol', 'uvoptx', 'qdfm', 'sql.j2', 'ths', 'voices', 'scntoc', 'bfi', 'bfft', 'jzml', 'inkml', 'preset', 'vdata', 'ls3proj', 'sts', 'pc', 'me2headmorph', 'gw3', 'ett', 'hocr', 'wxg', 'pbtx', 'gli', 'fstf', 'hmc', 't2t', 'mpak', 'slaz', 'bbp', 'rivers', 'sound', 'bfwav', 'sfi', 'vyp', 'hipnc', 'cn', 'psyexp', 'mti', 'sh~', 'tl7', 'me3headmorph', 'rb2', 'sbd', 'dgu', 'd1m', 'dmpatch', 'cmxa', 'activegsxml', 'fract', 'zfi', 'pcif', 'vge', 'aem', 'contest', 'checkpoints', 'altstate', 'actions', 'st6', 'town', 'sb7', 'f4p', 'hgm', 's37', 'ecmp', 'osz', 'k26', 'railml', 'mgh', 'sdml', 'pop.nc', 'rgss3a', 'l3r', 'm12', 'instances', 'tbx', 'vab', 'smbp', 'vbf', 'tpe', 'ti', 'lsxproj', 'rgss2a', 'lvl', 'nru', 'hsz', 'synmod', 'scd.gz', 'gmbl', 'lmt', 'fxe', 'v3d', 'zls', 'ifczip', 'ggxml', 'crmsh', 'svp', 'jci', 'tq5', 'emdl', 'ezt', 'smgsce', 'rlt', 'rdg', 'flz', 'sop', 'scen', 'rpx', 'mmms', 'cbmprj', 'journal', 'qot', 'sdat', 'fd', 'gw', 'x0v', '3dl', 'oph', 'sxt', 'kld', 'n3m', 'or5', 'ifbf', 'acs4', 'cvr', 'aegraphic', 'dzip', 'v2d', 'erd', 'nfd', 'sp5', 'hw6', 'szp', 'mui', 'aaruf', 'grle', 'tvm', 'ai8', 'mptm', 'bridgecache', 'qcmp', 'a4l', 'notecard', 'prpreset', 'st13', 'familyx', 'prod', 'tsm', 'dotfuproj', 'rpyc', 'ezdrawlibb', 'gkh', 'dat1', 'keyboard', 'feat', 'twc', 'vect', 'ldaprc', 'gin', 'ccvf', 'smgview', 'etherpad', 'ifx', 'vbo', 'mdsp', 'shex', 'qtt', 'rqda', 'af3', 'u8', 'ewnet', 'r2lang', 'muib', 'vismatzip', 'tss', 'ww5', 'nbk', 'fcpx', 'kegs', 'tn6', 'procreate', 'hexset', 'ap6', 'tbd', 'mprops', 'alg', 'xmz', 'silk', 'fcv', 'cwf', 'blut', 'ocio', 'lwr', 'bj', 'acelive', 'vwp', 'kft', 'sgn', 'plxml', 'vdjsample', 'rbxmx', 'icf', 'kfa', 'ays', 'cgns', 'jlqm', 'isd', 'graffle.zip', 'sth', 'a3s', 'flatpakrepo', 'rlb', 'pont', 'dtproj', 'gdtb', 'grape', 's4mi', 'isym', 'g722-6', 'rslib', 'mkt', 'redif', 'ln', 'mjd', 'kik', 'cmyk', 'gpml', 'pubkr', 'edp', 'cprops', 'tun', 'lsn', 'px4', 'ef3', 'mfs', 'dzi', 'ab5', '4df', 'glfont', 'thumbs.db:encryptable', 'puf', 'ac3mp', 'nav', 'ndpa', 'rout', 'f00', 'mgs', 'dlr', 'npc', 'hpkg', 'ppu', 'ehsx', 'kxr', 'rsdk', 'jet', 'omn', 'af2', 'shl', 'adfs', 'track', 'd2m', 'cydwr', 'mrg', 'lmp', 'mdtxt', 'tnt', 'hfd', 'appcache', 'px3', 'ts3_soundpack', 'svcinfo', 'zcode', 'g723-3', 'kb', 'i6t', 'wof', 'md5anim', 'wncry', 'cyprj', 'mqsc', 'nd', 'logbook3', 'trb', 'mys', 'bigwig', 'wtml', 'tssproj', 'civ5proj', 'twr', 'enmap', 'qbm', 'alaw', 'mae', '3x5', 'csa', 'dch', 'rsvo', 'script', 'ale', 'roh', 'dip', 'matte', 'ludwig', 'jp6', 'aik', 'pro5', 'hxr', 'wfd', 'lps', 'z81', 'mxr', 'fet', 'epdf', 'accdw', 'hpa', 'hts', 'xml.bz2', 'minibank', 'dob', 'picon', 'tax2009', 'lnf', 'lasx', 'irt', 'gipl', 'ofp', 'q3s', 'av', 'xdmf', 't09', 'farconfig', 'fprg', 'gob']"
trid,3907,485,12.413616585615562,11535,8236,608,"['wea', 'fh*', 'fsn', 'ofw', 'xeb', 'chesstitanssave-ms', 'rflw', 'pqf', 'cxi', 'zsync', 'ob3', 'lsc', 'ebc', 'take', 'vft', 'mfil', 'cdrzip', 'nuv', 'cmd5', 'ra3replay', 'caj', 'rjp', 'mode1v3', 'xcscheme', 'ybk', 'paq8f', '0', 'hxn', 'eyetvi', 'iem', 'clbx', 'appup', 'n2p', 'wdk', 'a78', 'gambas', 'btg', 'sew', 'r3a', 'acbm', 'jce', 'uci', 'ane', 'nftr', 'xtc', 'nr3', 'pcblib', 'flipchart', 'enc1', 'dva', 'xfb', 'xbk', 'tgw', 'xmd', 'rot', 'mou', 'apn', 'ppv', 'rbxl', 'query', 'sbpf', 'sgriddler', 'sui', 'egrp', 'egon', 'apnx', 'jap', 'ela', 't0*', 'gtx', 'argo', 'bxb', 'ipe', 's2ma', 'dwz', 'szx', 'pvp', 'ceg', 'dfw', 'wn', 'rpp', 'xise', 'eqf', 'xs5', 'phj', 'save', 'myr', 'ceb', 'eobj', 'zeg', 'xmct', 's2a', 'qzs', 'ond', 'qze', 'cinema4d', 'yka', 'symcache', 'crysisjmsf', 'kw3', 'zsg', 'ncsflib', 'lyx', 's2m', 'nrkt', 'opy', 'hpd', 'smzip', 'exm', 'ekb', 'xdr', 'w2m', 'lpaq', 'ilda', 'istg', 'lrprev', 'odv', 'j2b', 'twf', 'fd2', 'vmlt', 'er1', 'b6t', 'qz', 'bgdb', 'mp2s', 'schlib', 'btapp', 'b5t', 'awlive', 'mani', 'anbm', '8bf', 'core', 'xtr', 'dtg', 'nbm', 'unity3d', 'xtodvd', 'ovx', 'ssts', 'ncer', 'cdz', 'gwi', 'grs', 'dc5', 'xgr', 'mode2v3', 'nsx', 'nz', 'xmfg', 'h8t', 'npl', 'r2p', 'dh', 'site', 'bkr', 'tkn', 'xui', 'clmov', 'blob', 'brsar', 'mft', 'ratdvd', 'dcu', 'fg', 'vthought', 'cndf', 'vp6', 'cmml', 'fbf', 'cwr', 'unr', 'dplsave', 'echr', 'pwb', 'xsiaddon', 'arch00', 'smo', 'kfn', 'xpaddercontroller', 'ozv', 'tku', 'st3', 'kz', 'nfg', 'xdd', 'pz', 'xaiml', 'iws', 'mqp', 'mw2', 'maki', 'tbb', 'efg', 'mitsu', 'fed', 'ikmp', 'lgx', 'meb', 'ngd', 'lsim', 'b**', 'dks', 'b1n', 'rso', 'x64', 'zab', 'dpl', 'pgtb', 'fidx', 'q1', 'arp', 'gpi', 'cmmf', 'gab', 'bmu', 'narc', 'xlo', '8xk', 'fns', 'mk2', 'iw2', 'sac', 'd2s', 'kodu', 'frz', 'sims2pack', 'wxn', 'xs3', 'ars', 'hlx', 'minincsf', 'jcb', 'zfx', 'pvn', 'nfc', 'ncs', 'prf2', 'xfr', 'phc', 'nmea', 'r2s', 'ncgr', 'xbel', 'fxo', 'tbs', 'ffe', 'xferd', 'pcu', 'wm2d', 'amw', 'uvo', 'xgs', 'wgs', 'eop', 'paq8o', 'vpdb', 'zmi', 'strm', 'dvds', 'i3f', 'xsb', 'ev2', 'qlb', 'phr', 'ytf', 'mm8', 'xpdl', 'pumpkin', 'xks', 'r3p', 'cc3d', 'kcm', 'mqv', 'wdy', 'swidtag', '4cm', 'me3', 'pmlz', 'pdm', 'npp', 'psu', 'asvf', 'tngz', 'wwp', 'ctw', '8*', 'tiz', 'lg32', 'pch2', 'gvp', 'chk', 'pgs', 'wdi', 'eit', 'v00', 'xbs', 'xwp', 'vlcl', 'catalog', 'pbu', 'm99', 'stu', 'mcdx', 'els', 'xrf', 'xpo', 'glox', 'stuff', 'hjt', 'wk*', 'epm', 'bs4', 'xds', 'nma', 'ilx', 'c10', 'developerprofile', 'crysispsf', 'fbrb', 'dce', 'mmdb', 'cak', 'uce', 'fdat', 'nclr', 'xwb', 'cai', 'hg1', 'gq', 'xmv', 'asif', 'cl2arc', 'xnk', 'tpg', 'zno', 'phn', 'kws', 'apkg', 'wotreplay', 'ptn', 'rez', 'guikit', 'kexi', 'psk', 'dream', 'tsc', 'bav', 'vlx', 'xzp', 'tk3', 'mw4', 'tms', 'paq8l', 'mws', 'jbi', 'jef', 'vpt', 'sims3pack', 'st*', 'n2v', 'xrc', 'qx', 'gau', 'sgpg', 'ufi', 'xrp', 'civ5map', 'omfi', 'uccapilog', 'w3m', 'r2a', 'xs4', 'udd', 'wdg', 'adu', 'hfz', 'uti', 'smol', 'nvram', 'vcm', 'xadml', 'p4x', 'gbc', 'xdt', 'viivo', 'dmm', 'sfb', 'mtd', 'nanr', 'sdata', 'cdo', 'fca', '3th', 'wz', 'nmsv', 'frec', 'xep', 'comicdoc', 'rwsd', 'xrm-ms', 'cals', 'nm2', 'brres', 'btd', 'ntt', 'smw', 'haptar', 'amff', 'adif', 'cbin', 'wyg', 'shprst', 'pd3', 'caproj', 'piv', 'film', 'erx', 'psy', 'sbw', 'nov', 'odcl', 'b2z', 'ank', 'dtk', 'm2i', 'rcad', 'pzd', 'depot', 'vnt', 'xp2', 'l6t', 'shtmbr', 'ozf2', 'tlp', 'mkf', '1sc', 'qzd', 'pando', 'dvg', 'speccy', 'mv3', 'ztl', 'mco', 'ckf', 'gocad', 'ium', 'rxf', 'pez', 'clg', 'oes', 'zxs', 'any', 'sns', 'ypr', 'edg', 'cmb', 'snm', 'czd', 'xwf', 'aswcs', 'bvd', 'mc4d', 'dxs', 'xws', 'xamlx', 'qmbl', 'loc', 'cdf-ms', 'mqb', 'jsd', 'dwi', 'qp03', 'tns', 'dmb', 'bio', 'grz', 'mva', 'pbxuser', 'companylogo', '8xu', 'kwo', 'vmlf', 'ytr']"
ffw,3765,651,17.290836653386453,15300,8985,749,"['moef', 'p60a', 'cell', 'firpiv', 'bb2', 'teo', 'reltdemo', 'pxt', '?q?', 'z2', 'xkm', 'sd2f', 'lz5', 'p40a', 'qoir', 'npf', 'ur2', 'jpk', 'dmsp', 'hcrx', 'locked', 'sir', 'mshc', 'c2', 'fu', 'pnl', 'c00', 'x??', 'arg', 'ling', 'aclcddb', 'ftb-shm', 'ows', 'timg', 'qce', 'paq', 'um', 'moti', 'anmb', 'sbsm', 'ilc', 'is14', 'cdxl', 'wand', 'gar', 'clh', 'psmodel', 'edifact', 'exc', 'mur', 'cix', 'tax2014', 'bh2pcm', 'su', 'x12', 'uzed', 'incx', 'sh3f', '1dd', 'dog', 'dgk', 'tax2012', 'sc1', 'sg1', 'lzd', '@00', 'zar', 'b58', 'abcddb-shm', 'ftb-wal', 'qcotfe', 'dm4', 'yp', 'xir', 'obml15', 'vzi', 'sie', 'imt', 'sn2', 'p50a', 'dut', 'dr2d', 'plh', 'rc2', 'pg0', 'opt*', 'g11', 'gs9', 'obf', 'cpz', 'mok', 'acd-zip', 'disc', 'blg', 'mpfa', 'reidemo', 'emod', 'novabackup', 'dmcs', 'syj', 'scrn', 'ril', 'fpw', 'fge', 'odict', 'cdu', 'z1', 'gs3', 'nomedia', 'pg2', 'backup2', 'sq', 'da3', 'spfs', 'dap', 'tud', 'icmt', 'xrj', 'nii.gz', 'deh', 'lbw', 'real', 'ync', 'btfnt', '4pl', 'jpet', 'sok', 'osgb', 'rkv', 'kea', 'rh', 'i6', 'da1', 'param', 'tlmz', 'shed', 'jpgt', 'gs2', 'lzw', 'baka', 'shb', 'ptvoice', 'zpng', 'gbproj', 'hci', 'mine', 'lwi', 'd71', 'sprite2', 'efu', 'hostnames', 'abcddb-wal', 'cursorfx', 'pjxl', 's3g', 'gs5', 'fyb', 'dorico', 'dvp', 'ipc', 'pv', 'p61a', 'mx1', 'sh3p', 'gs8', 'dmse', 'core3d', 'zax', 'hrx', 'animated', 'dgp', 'zgr', 'wu', 'hxa', 'xxe', 'hxe', 'br4', 'sid2', 'sai', 'eup', 'gdz', 'schematic', 'seqbox', 'eaz', 'zzz', 'da5', 'pm!', 'pdzx', 'gdx', 'aca', 'frdat', 'pmq', 'szt', 'gr3', 'nts', 'vaxl', 'dpdoc', 'mhp', 'xmit', 'mp3pro', 'ttp', 'mvn', 'iklax', 'dg1', 'cdptz', 'gr9', 'bb1', 'pm$', 'ftmd', 'frozen.rs', 'hbm', 're$', 'bb0', 'imj', 'unv', '?z?', 'mzdata', '2dk', 'p3c', 'rsecc', 'nl3', 'prun2', 'brik', 'sbeir', 'fyi', 'dc1', 'mom', 'pnd', 'gr', 'e3d', 'kwi', 'zxt', 'fcpbundle', '113', 'wrap', 'g9s', 'gr1', 'gs7', 'rt3', 'zp1', 'vo', 'wuffs', 'fntdata', 'ssb', 'wsa', 'mch', 'fle', 'hra', 'ghg', 'hrg', 'colors', 'dph', 'p40b', 'hit', 'p30a', 'lispm', 'gr8', 'tile', 'iconpackage', 'ndtx', 'motr', 'lurk', 'da2', '814', 'dor', 'cl1', 'ibw', 'xowa', 'cptx', 'ir2', 'wbp', 'oo3', 'irg', 'tree', 'sy3', 'mcpp', 'tgx', 'pixi', 'library', 'gs6', 'cex', 'dry', 'cfi', 'frn', 'wat.gz', 'dzv', 'mfe', 'osd', 'prs.xml', 'jigdo', 'fgs', '$00', 'epsgmod', 'vw3', 'moff', 'zc', 'ebz', 'abp', 'z6', 'ize', 'him', 'nrf', 'liz', 'xcfbz2', 'unitypackage', 'esw', 'wsy', 'speech', 't3g', 'nfp', 'rd3', 'rm4', 'tx0', 'log1', 'xnf', 'bgw', 'wxpr', 'qsg', 'hut', 'dn', 'gs4', 'gr9p', 'level', 'mvp', 'z4', 'strings', 'lp3', 'bbg', 'sprite3', 'qd3', 'aq', 'castep', 'ip2', 'nft', 'pci', 'harp', 'ko', 'ree', '4v', 'flk', 'pdraw', 'etb', 'pspd', 'gr7', 'tlz', 'fwa', 'ivg', 'motn', 'rej', 'wxv', 'itlp', 'pbix', 'mwand', 'rax', 'hpx', 'nlx', 'wll', 'bmc4', 'umz', 'reedemo', 'vtd', 'bb4', 'rw', 'tok', 'cl0', 'ftg', 'tbkx', 'br3', '@01', 'vfa', 'pmi', 'table', 'pg1', 'bitsboard', 'rys', 'hfc', 't2g', 'uns', 'fiz', 'rkplr', 'hr', 'nksc', 'aex', 'etar', 'cpa', 'pg3', 'olm', 'z7', 'fmrpiv', 'zci', 'ecdc', 'mshi', 'abcddb', 'td4', 'rcproject', 'warc.gz', 'idtf', 'gwd', 'tileskin', 'fadein', 'aussie', 'cec', 'ratfor', 'obml16', 'sgo', 'directory', 'esc', 'sb3', 'sic', 'pu', 'ocp', 'rir', 'txs', 'vfc', 'igb', 'nil', 'uc0', 'eve.exe', 'nlb', '??~', 'prel', 'rbpack', 'sai2', 'ben', 'rdq', 'mars', 'ftmm', 'cfz', 'lzz', 'phm', 'rsndemo', 'ap3', 'gs1', '?01', 'utp', 'vig', 'icma', 'emn', 'x01', 'ss4', 'edrw', 'hw3', 'horcrux', 'life', 'aipd', 'backup', 'ecsbx', 'nrt', 'scodl', 'ihe', 'aclcddb-shm', 'bnsf', '256', 'rcy', 'bru', 'jd', 'reld', 'aftemplate', 'eve', 'osgt', 'ucn', 'tux', 'mle', 'dr5', 'tds', 'backup3', 'zck', 'scptd', 'mci', 'vfj', 'bb5', 'gtc', 'uhi', 'agp', 'amp.html', 'fast5', 'rm1', 'g10', 'bs2', '1dk', 'afpub', 'dio', 'pja', 'snapshot', 'fldr', 'mph', 'hr2', 'shielded', 'quorum', 'lxi', 'backup1', 'dsdr', 'xx', 'solution', 'deck', 'abw.gz', 'sef', 'sbsar', 'rm0', 'cddz', 'gdi', 'prun1', 'mnf', 'fhm', 'xie', 'bts', 'sas7dat', 'p22a', 'acdc', 'dra', 'vfx', 'fsl', 'nwr', 'ugz', 'hxv', 'mpic', 'ibq', 'dictionary', 'bun', 'fec', 'p4i', 'd81', 'hel', 'il', 'relt', 'wsn', 'catprocess', 'pmn', 'bos', 'ugoira', 'nxi', 'chan', 'fl32', 'spb', 'in3', 'sc0', 'sc?', 'ary', 'jgp', 'bcd', 'na', 'savf', 'pae2', 't4g', 'mbg', '??%', 'ptnoise', 'ala', 'hss', 'qim', 'rm2', 'flh', 'vmm', 'prism', 'pwx', 'ipn', 'bruh', 'sh3t', 'vcf2', 'quest-save', 'jsong', 'baf', 'rltd', 'in2', 'frq', 'device', 'rle3', 'msha', 'hxk', 'dict', 'gr2', 'sndanim', 'zae', 'rsc32', 'rarbase64', 'hw4', 'bml', 'kap.txt', 'jpegt', 'tsz', 'wa', 'hjson', 'tad', 'van', 'rdt', 'scs4', 'hxc', 'btn', 'rse32', 'wrp', 'nmm', 'markdn', 'xclass', 'design', 'iw', 'zsm', 'rm3', '4pm', 'crai', 'mbl', 'cells', 'cal3d', 'playground', 'zrtf', 'dwm', 'kfp', 'rma', 'ldbst', 'obb', 'dma', 'erlu', 'bek', 'iptheme', 'sge', 'dmsa', 'wrld', 'ooutline', 'isc', 'apa', 'aclcddb-wal', 'abex', 'isoimg', 'ml1', 'cle', 'nwf', 'idms', 'xcodeproj', 'asdf', 'gr0', 'etbu', 'ntr', 'bsb.txt', 'ftb', 'rwh', 'ap2', 'cdlx', 'minesweepersave-ms', 'log2', 'kbm', 'tbpd', 'tax2011', 'sifz', 'ar7', 'tdd', 'uhc', 'sfg', 'alan', 'pph', 'tpdb8', 'rki', 'cdpx']"
pronom,1678,73,4.350417163289631,16978,9075,90,"['qtm', 'wmo', 'framemd5', 'pgma', 'hq.uef', 'pgmb', 'pbmb', 'w09', 'e17', 'w14', 'e20', 'qxp%20report', 'e04', 'w05', 'trn', 'w03', 'w19', 'ft3', 'e11', 'ogmu', 'e06', 'ogwu', 'w17', 'ft2', 'w11', 'w12', 'prapic', 'w04', 'qxp report', 'w18', 'ucsf', 'sbxls', 'w15', 'e07', 'w20', 'w21', 'e12', 'exclude', 'e08', 'swatches', 'src.rpm', 'e13', 'w13', 'e15', 'opju', 'e10', 'ogw', 'e09', 'yenc', 'w08', 'e03', 'e19', 'nms', 'e14', 'w10', 'vml', 'w02', 'err', 'vsm', 'w16', 'ega', 'ppmb', 'afi', 'mxi', 'w06', 'cog', 'gcc', 'e18', 'e05', 'w07', 'oggu', 'w22', 'e16']"
linguist,1414,583,41.23055162659123,18392,9675,600,"['raku', 'templ', 'sublime-syntax', 'mkdn', 'dhall', 'tac', 'ndproj', 'nginxconf', 'rakumod', 'sha224', 'lektorproject', 'axml', 'cylc', '9', '4dform', 'eclass', 'fir', 'antlers.html', 'rbbas', 'mbt', '3qt', 'hxsl', 'move', 'rbuild', 'xojo_report', 'coq', 'eliomi', 'syntax', 'xojo_toolbar', 'ruby', 'jsh', 'viw', 'wsgi', 'jav', 'eh', 'matlab', 'builder', 'graphqls', 'sublime-keymap', 'twig', 'containerfile', 'c++-objdump', 'psgi', 'ol', 'hocon', 'props', 'rs.in', '4dproject', 'yacc', 'os', 'prisma', 'csx', 'ispc', 'launch', 'hxml', 'njk', 'zig.zon', 'fancypack', 'rbmnu', 'edgeql', 'sha256sum', 'pcss', 'json5', 'tool', 'builds', 'mligo', 'd-objdump', 'hlean', 'webmanifest', 'reek', 'ecr', 'jscad', 'vhi', 'resi', 'gtpl', '1x', 'djs', 'nu', 'nproj', 'gdshader', 'j2', 'ron', '4gl', 'iuml', 'vtl', 'gshader', 'p6m', 'dircolors', '6pm', 'bicep', 'linq', 'depproj', 'gdnlib', 'xml.dist', 'matah', 'logtalk', 'f08', 'rbxs', 'vshader', 'yml.mysql', 'bbappend', '8xp.txt', 'ltx', 'rmiss', 'ahkl', 'zsh-theme', 'jbuilder', '6pl', 'grace', 'cmake.in', 'gaml', 'cs.pp', 'ml4', 'cljscm', 'druby', 'rpgle', 'tlv', 'c++objdump', 'gdshaderinc', 'gbl', 'gitconfig', 'gypi', 'mdwn', 'gsx', 'tpb', 'html.hl', 'ur', 'r2', 'h.in', 'jison', 'pegjs', 'cginc', 'pascal', 'pyde', 'ixx', 'vbhtml', 'kojo', 'rebol', 'circom', 'sats', 'mzn', 'glslf', 'sage', 'wikitext', 'code-workspace', 'wit', 'marko', 'pgsql', 'cxx-objdump', 'mdoc', 'cjsx', 'ejs.t', 'slang', 'yaml-tmlanguage', 'crc32', 'pmod', 'numpy', 'mirah', 'plot', 'ligo', '_ls', 'javascript', 'sublime-build', 'cats', 'srdf', 'tmux', 'p6l', 'minid', 'jslib', 'json-tmlanguage', 'qhelp', 'purs', 'xojo_menu', 'oxo', 'nomad', 'mir', 'leex', 'sjs', 'sarif', 'rg', 'sfproj', 'regexp', 'weechatlog', 'xib', 'nse', 'neon', 'yaml.sed', 'imba', 'ne', 'rabl', 'fshader', 'txx', 'rdoc', 'numpyw', 'handlebars', 'bzl', 'esdl', 'smt2', 'axaml', 'pbtxt', 'bbclass', 'sru', 'jisonlex', 'cljs.hl', 'mkvi', 'cljx', 'asddls', 'gyp', 'cake', 'nss', 'gradle', 'mkdown', 'code-snippets', 'click', 'rbi', 'dyalog', 'xsjs', 'cairo', 'xpy', 'gql', 'targets', 'hs-boot', 'uplc', 'pddl', 'mysql', 'sail', 'ijm', 'lfe', 'self', 'frag', 'mly', 'mlir', 'fpp', 'vto', 'rpy', 'c-objdump', 'eq', 'gnuplot', 'nimble', 'eam.fs', 'lmi', 'jinja2', 'mqh', 'nanorc', 'astro', 'urdf', 'jspre', 'zmpl', 'sagews', 'ks', 'rnh', 'hbs', 'flex', 'xc', 'regex', '1m', 'xsp.metadata', 'fsti', 'lasso9', 'puml', 'ihlp', 'chem', 'ux', 'vhf', 'xojo_window', 'emacs', 'angelscript', 'tl', 'tfvars', 'caddyfile', 'cshtml', 'axs.erb', 'muf', 'lark', 'vark', 'nearley', 'tesc', 'tese', 'hqf', 'mdpolicy', 'nims', 'qmd', 'star', 'axi', 'auk', 'sublime-commands', 'mediawiki', 'pkgproj', 'a51', 'ddl', 'sthlp', 'ampl', 'ashx', 'cppm', 'mq5', 'ssjs', 'apacheconf', 'cdc', 'pod6', 'cljc', 'cy', 'escript', 'maxhelp', 'dll.config', 'jinja', 'pact', 'ring', 'clar', 'postcss', 'hoon', 'mathematica', 'trigger', 'sj', 'lasso8', 'rego', 'spin', 'desktop.in', 'coffee.md', 'elv', 'ob2', 'xsp-config', 'emberscript', 'latte', 'irclog', 'p6', 'bones', 'nr', 'aidl', 'vh', 'cocci', 'religo', 'slint', 'wxi', 'prefab', 'zimpl', 'polar', 'mawk', 'xsh', 'js.erb', 'snippet', '3in', 'razor', 'soy', '1in', 'nawk', 'iol', 'es6', 'vhs', 'textproto', 'cobol', 'volt', '3m', 'pd_lua', 'mkfile', 'gbo', 'tftpl', 'tu', 'xsjslib', 'yasnippet', 'sttheme', 'mjml', 'bison', 'make', 'sha2', 'html.eex', 'agc', 'antlers.php', 'rst.txt', 'eliom', '_js', 'mermaid', 'inl', 'duby', 'bats', 'edc', 'livemd', 'prawn', 'cuh', 'opal', 'fxh', 'nginx', 'vht', 'app.src', 'pasm', 'snakefile', '3x', 'mumps', 'ston', 'kak', 'workbook', 'zsh', 'mako', 'sublime_session', 'swig', 'shader', 'vhost', 'nasl', 'boot', 'mkiv', 'gdns', 'apib', 'rnw', 'erb.deface', 'toit', 'blade', 'tfstate.backup', 'topojson', 'jelly', 'txi', 'raml', 'hhi', 'prw', 'snippets', 'ejs', 'idc', 'watchr', 'qasm', 'p4', 'brs', 'hql', 'vba', 'psc1', 'eb', 'rest.txt', 'livecodescript', 'mustache', 'xproc', 'scenic', 'xproj', 'intr', 'arpa', 'jq', 'jai', 'mint', 'sexp', '3pm', 'hrl', 'xzap', 'tcl.in', 'xojo_code', 'sublime-settings', 'rno', 'command', 'plantuml', 'clixml', 'svelte', 'lkml', 'gawk', 'cpp-objdump', 'bicepparam', 'service', 'yul', 'cnc', 'gnu', 'x68', 'pyp', 'cppobjdump', 'oz', 'heex', 'dfy', 'ronn', 'libsonnet', 'riot', 'wisp', 'gko', 'em', 'xspec', 'gto', 'kdl', 'cirru', 'eclxml', 'mmk', 'sublime-menu', 'emacs.desktop', 'yap', 'podsl', 'wl', 'cbx', 'xrl', 'sublime-color-scheme', 'mtml', 'talon', 'gni', 'lookml', 'py3', 'jte', 'grt', 'overpassql', 'unity', 'conll', 'gjs', 'ktm', 'pytb', 'bsl', 'antlers.xml', 'slnx', 'rbuistate', 'parrot', '4dm', 'hats', 'dats', 'sublime_metrics', 'clue', 'uno', 'cjs', 'asn', 'http', 'tfstate', '_coffee', 'sha384', 'rbres', 'ebuild', 'blade.php', 'haml.deface', 'vert', 'decls', 'monkey2', 'ninja', 'resource', 'jake', 'forth', 'iced', 'ksh', 'wlua', 'sublime-macro', 'mspec', 'nqp', 'sha3', 'gpt', 'pogo', 'doh', 'opencl', 'peggy', 'mata', 'pprx', 'rchit', 'urs', 'xacro', 'rbtbar', 'flux', 'creole', 'gleam', 'xojo_script', 'dtx', 'curry', 'zmodel', 'sublime-completions', 'editorconfig', 'vmb', 'numsc', 'lslp', 'yara', 'lvclass', 'd2', 'pluginspec', 'glslv', 'ipp', 'workflow', 'json.example', 'ect', 'sh-session', 'rockspec', '3p', 'axi.erb', 'sqlrpgle', 'gdbinit', 'gradle.kts', 'omgrofl', 'plsql', 'sublime-theme', 'thor', 'trg', 'sh.in', '8xp', 'dzn', 'vhw', 'nim.cfg', 'ql', 'epj', 'veo', 'yrl', 'sparql', 'hlsli']"
tika,1174,253,21.550255536626917,19566,9934,259,"['wmlc', 'xconf', 'fh50', 'rdz', 'oas', 'ptid', 'dist', 'a_txt', 'urls', 'egrm', 'nns', 'list3820', 'junit', 'hpid', 'ghf', '^owl$', 'ifm', 'joda', 'grm', 'ocaml', 'xo', 'deploy', 'rnx', 'et3', '*-gz', 'msty', 'portpkg', 'mpe', 'zmm', 'xroles', 'xld', 'gex', 'link66', 'ufd', 'sus', 'distz', 'frame', 'aart', 'jx', 'semd', 'pen', 'mpm', 'itk', 'ei6', 'bh2', 'wmls', 'ecma', 'eol', 'kia', 'mqy', 'knp', 's_txt', 'chat', 'p7r', 'fv', 'bcpio', 'curl', '3dml', 'ecelp7470', 'sfd-hdstx', 'setreg', 'xpx', 'daf', 'kne', 'jpgv', 'dfac', 'c4g', 'x32', 'fh', 'rcprofile', 'gqf', 'seed', 'ad.txt', 'ihtml', 'wtb', 'sldx', 'rpss', 'teacher', 'rms', 'ktr', 'tmo', 'c4u', 'chrt', 'sdkd', 'boz', 'cii', 'mcurl', 'fzs', 'semf', 'u32', 'itp', 'adoc.txt', 'hbci', 'xegrm', 'anpa', 'csml', 'wbxml', 'nnd', 'oprc', 'qam', 'latex', 'uri', 'h263', 'scurl', 'readme', 'davmount', 'qps', 'gqs', 'classpath', 'pcurl', 'lostxml', 'susp', 'uris', 'tcap', 'xlog', 'shf', 'skt', 'xsamples', 'wqd', 'clkp', 'wsdd', 'mp4v', 'pclxl', 'xenc', 'ez', 'acfm', 'slt', '.htaccess', 'ecelp4800', 'iso19139', 'xcat', 'twds', 'mp4s', 'mmat', 'igl', 'etx', 'sse', 'xmap', 'nnw', 'gre', 'mmas', 'hvp', 'sv4crc', 'nlu', 'tpt', 'keys', 'htke', 'cdbcmsg', 'atomcat', 'kpt', 'btif', 'dcurl', 'ecelp9600', 'mmmp', 'umj', 'rtx', 'mseq', 'mseed', 'uoml', 'roles', 'rpst', 'spot', 'karbon', 'mwf', 'i_txt', 'cdkey', 'osfpvg', 'xargs', 'xweb', 'unityweb', 'mscml', 'mp4a', 'xlex', 'fg5', 'clkw', 'abs-linkmap', 'pkipath', 'ivp', 'emma', 'abs-menulinks', 'dna', 'zirz', 'mpga', 'wspolicy', 'ufdl', 'kon', 'grb1', 'fh40', 'rld', 'les', 'acutc', 'flw', 'gac', 'xpw', 'efif', 'plf', 'aso', 'mpy', 'bpk', 'ngdat', 'wmlsc', 'xop', 'lrm', 'oa2', 'cwiki', 'xhvml', 'c4p', 'xwelcome', 'oa3', 'odft', 'listafp', 'sdkm', 'pvb', 'c4f', 'lbd', 'kfo', 'xvm', 'h261', 'lvp', 'onetmp', 'fhc', 'gtw', 'oda', 'setpay', 'gram', '^rdf$', 'irm', 'install', 'mpg4', 'xslfo', 'clkt', 'jlt', 'maker', 'jpgm', 'mmpt', 'mp2a', 'sema', 'sv4cpio', 'asnd', 'ft12', 'lbe', 'dataless', 'cdy', 'xvml', 'amfm', 'xbd', 'clkk', 'zaz', 'kwt', 'm13', 'xgrm', 'fh12', 'restx']"
file,736,80,10.869565217391305,20302,10016,82,"['_', 'fxx', 'ful2', 'wc', 'grib2', 'j01', 'grib', 'hwpx', 'xoj', 'bfstm', 'j02', 'srd-shm', 'kicad_sch-bak', 'xia', 'trc0', 'xbt', 'imgc', '?_', 'mrs', 'pkd', 'cdrt', 'divx', 'bmk', 'wxx', 'vbox-extpack', '008', 'pwz', 'hwl', 'icsalarm', '$ts', 'rmeta', 'pe5', '?$', 'a68', 'dbx-shm', '012', 'asar', 'framemif', 'wt4', 'sysex', 'help', 'dc42', 'xis', 'wsb', 'rgn', 'aria2', 'bcwav', 'jsbundle', 'uwl', 'fj3', 'ja', 'sqlite2', 'bcstm', 'pmv', 'vbx', '$xe', 'pp_', 'iso9660', 'gxc', 'gkb', 'upk', 'dbe', 'stex', 'deskthemepack', '__d', 'w40', 'nod', 'dbpf', '3gr', 'ntfs', 'tr1', 'trc1', 'maple', 'db3-shm', 'clamtmp', '18', 'aup3-shm', 'kicad_pcb-bak', 'irs', 'profm']"
naradpf,591,51,8.629441624365482,20893,10071,55,"['x-mpeg2a', 'frontpg.ini', 'pip', 'bkl', '3gg2', 'service.lck', 'sunras', '3gp2', 'mpeg3', 'mp2p', 'a86', 'plain_text', 'xhtm', 'rt#', 'x-mp3', 'connected node spatial index', 'frontpg.cnf', 'l16', 'mpeg2', 'sdxf', 'primitive', '0xx', 'x-mpeg', 'frontpg.lck', 'qta', 'others', 'utf16', 'autorun.inf', 'bl', 'dht', 'x-pn-mpg', 'wrl.gz', 'ole2', 'x-mpg', 'jtip', 'mdm', 'dl_', 'zdct', 'x-mpeg3', 'mp1s', 'ole', 'ft#', 'csi', 'utf', 'temp', '10', 'mp2t', 'm2p', 'l41', 'utf8', 'x-mpegaudio']"
lcfdd,487,43,8.829568788501026,21380,10114,43,"['par3', 'df2', 'df6', 'atmos.metadata', 'map.xml', 'df8', 'loas', 'bipw', 'ex01', 'vrm', 'cmpt', 'damf', 'b3dm', 'slpk', 'bfm', 'atmos', 'rlcw', 'not applicable.', 'ws2', 'tar.gz', 'enlp', 'hdfeos', 'ppc', 'lx01', 'pth', 'df4', 'i3dm', 'atmos.audio', 'df5', 'pt24', 'df0', 'rcw', 'jmh', 'bmpw', 'pnts', 'sec', 'xhe', 'doq', 'wkt', 'df7', 'ptif', 'bsqw', 'df9']"
tcdb,190,29,15.263157894736842,21570,10143,29,"['.pun', 'fht', 'fttb', 'ap1', 'ssd01', 'ftds', 'px1', 'pm7', '.rls', 'ftop', 'sct01', 'ssv01', 'ftpc', '.ep', 'qpc', 'rrs', 'nzl', 'cid', 'qsc', 'ftsc', 'snx01', 'qpl', 'ssp01', 'eqn', 'fm5', 'wkn', 'fatp', 'pict, pic', 'ftwp']"
mediainfo,46,2,4.3478260869565215,21616,10145,2,"['mpgv', 'irca']"
